30 100
CATGACTCGACTTATGATTTGCACGAGTGC|TAGAAGAGAGGTGTCCCTTGAAGGGCTGGA
ATCTTTACGGGTCGGTGGCGCTCTATTAAT|CCAATCACTACGAGATTACACACTGGGTGC
CGGTGGCGCTCTATTAATAACGACCAGACT|AGATTACACACTGGGTGCGCCGGAGATGTC
GTGCTCACCCAGACTCGACTTATGATTTGC|ATGATTTGCACGAGTGCTAGACGAGTCTAA
GGGTGATAACCATGACTCGACTTATGATTT|GCACGAGTGCTAGAAGAGAGGTGTCCCTTG
GACTTATGATTTGCACGAGTGCTAGAACTC|CGAATGGTGTGAATGGACGCGTGTCTGCGC
TCACGGTATGCCATAACGATTTCCCTCTAT|TTGCATCTCTTTACCAGTGGTTGGCTTAAC
TGTGATCGTTTGGTGAAGTCGTAACTTGAG|AATGTAGAATCCAAGATAAATCAATAGTAG
AGAAAGACCGACTAAAGTAAGGAACTCGAC|GCTCACCCAGACTCGACTTATGATTTGCAC
TCGCCATAAGTTTCACGTACCATGATAAGG|TAGACACTCAGAAACCTTCGAGGGGGCTTC
TTTGCACGAGTGCTAGATATCAACGCTAAT|GACGCCAGCTCGAATGTGCAAGATAATCTT
CTAGACACGAACTCGACTTATGATTTGCAC|CCCTGCATTGGTGGTTGGACATGAATGTGA
CCGACTAGGGTATTCATAGAGAACGAGGAT|GAAACGCGATATTCGCAGCATTGCCCTATA
TGGTGAAGTCGTAACTTGAGTCGGGCTAAA|CCAAGATAAATCAATAGTAGAAAGACCGAC
TGCACGAGTGCTAGAAGAGAGGTGTCCCTT|ACAACCGACTAGGGTATTCATAGAGAACGA
CAATAGTAGAAAGACCGACTAAAGTAAGGA|GGGGTGTGCTCACCCAGACTCGACTTATGA
GAGGATGTTAGGTTGACGCGAATGCCATAG|CCTATACATTCTACCGTGAGCTCATAATCG
ATTCACGGTATGCCATAACGATTTCCCTCT|CATTGCATCTCTTTACCAGTGGTTGGCTTA
GGGTGTGCTCACCCAGACTCGACTTATGAT|ACTTATGATTTGCACGAGTGCTAGACGAGT
CCTACTCTCCCACTCGACTTATGATTTGCA|AGTAAGGAACTCGACTTATGATTTGCACGA
CTAGAAGAGAGGTGTCCCTTGAAGGGCTGG|AGGGTATTCATAGAGAACGAGGATGTTAGG
CTTATGATTTGCACGAGTGCTAGAACCCAA|TGCCATAGTTGGCCCCTGACGTCTACCATA
ACGCGAATGCCATAGTTGGCCCCTGACGTC|GTGAGCTCATAATCGGTTCGTGTATTCGCC
GTGTGAATGGACGCGTGTCTGCGCATCTAG|CCTACTCTCCCACTCGACTTATGATTTGCA
CAGCTACCTCCTGCAGATCGCGCTGAGTCC|CGATTTCCCTCTATGGACTTACACACTCGA
TTTGCACGAGTGCTAGAACTCGACTTATGA|CTAGACCCTGCAGATGTCGATCACAGACCG
TGAATTGTTCGAGGGGGTGTGCTCACCCAG|AGTGCTAGAACTCGACTTATGATTTGCACG
GAGTGCTAGACGAGTCTAAGCTTGTAAGCA|ACACCTGGTGTTGCTAAATGACACTCGACT
AGTAAGGAACTCGACTTATGATTTGCACGA|ACTTATGATTTGCACGAGTGCTAGATGACA
CGGAGATGTCTCTAGGGCATCAACAACCGA|ACGTACCATGATAAGGGCGCAGCGACGAAA
AACTCGACTTATGATTTGCACGAGTGCTAG|TCGATCACAGACCGTCGCGATACACCTGGT
TCACGTACCATGATAAGGGCGCAGCGACGA|AACCTTCGAGGGGGCTTCGCCCAGCCAGCT
CCAAGATAAATCAATAGTAGAAAGACCGAC|AATTGTTCGAGGGGGTGTGCTCACCCAGAC
TTATGATTTGCACGAGTGCTAGACACGAAC|GGACTCATGTTGGCACAGCCCTGCATTGGT
CTAGGGTATTCATAGAGAACGAGGATGTTA|CGCGATATTCGCAGCATTGCCCTATACATT
GACGCGTGTCTGCGCATCTAGGTCAGTTGC|CCACTCGACTTATGATTTGCACGAGTGCTA
CGATTTCCCTCTATGGACTTACACACTCGA|GTGGTTGGCTTAACTCGACTTATGATTTGC
GCTAGAAGACTAGACGCCAGCTCGAATGTG|GAAGGACTCGACTTATGATTTGCACGAGTG
GCAAGATAATCTTTACGGGTCGGTGGCGCT|GCTAGAACCCAATCACTACGAGATTACACA
ACTTACACACTCGACTTATGATTTGCACGA|GACTTATGATTTGCACGAGTGCTAGACCCT
CCTGGTGTTGCTAAATGACACTCGACTTAT|GACTTATGATTTGCACGAGTGCTAGAAGAC
CGGCGAATGTTGAATTGTTCGAGGGGGTGT|GATTTGCACGAGTGCTAGAACTCGACTTAT
ATTTGCACGAGTGCTAGAAGACTAGACGCC|CTTGAAGGGCTGGAAGGACTCGACTTATGA
CACGAGTGCTAGAAGACTAGACGCCAGCTC|AGGGCTGGAAGGACTCGACTTATGATTTGC
TGCTAGATCGTATCAATTACAGCTACCTCC|TATTCACGGTATGCCATAACGATTTCCCTC
GATAACCATGACTCGACTTATGATTTGCAC|GAGTGCTAGAAGAGAGGTGTCCCTTGAAGG
GAAGCGAATGTAGAATCCAAGATAAATCAA|TGTACGGCGAATGTTGAATTGTTCGAGGGG
ATGACACTATTCACGGTATGCCATAACGAT|TAATCTAACATTGCATCTCTTTACCAGTGG
AGCGACGAAACGCGATATTCGCAGCATTGC|AGCCAGCTCGATGATTCAACGTAGAGCAAG
AGCTCGAATGTGCAAGATAATCTTTACGGG|TTTGCACGAGTGCTAGAACCCAATCACTAC
TGCAGATCGCGCTGAGTCCTTGTACGGCGA|TATGGACTTACACACTCGACTTATGATTTG
GTCTACCATATTTCAACCGGGGAATCGCCA|GCCAAAAGGACACAGAGGGGTTACTAGACA
ACGATTTCCCTCTATGGACTTACACACTCG|AGTGGTTGGCTTAACTCGACTTATGATTTG
GATTTGCACGAGTGCTAGAAGAGAGGTGTC|ATCAACAACCGACTAGGGTATTCATAGAGA
CATCTCTTTACCAGTGGTTGGCTTAACTCG|AGTGCTAGATATCAACGCTAATAGTGGCTA
GAATGTGATCGTTTGGTGAAGTCGTAACTT|GCGAATGTAGAATCCAAGATAAATCAATAG
TCGACTTATGATTTGCACGAGTGCTAGATA|CTAGAAGACTAGACGCCAGCTCGAATGTGC
GACCGTCGCGATACACCTGGTGTTGCTAAA|TGATAACCATGACTCGACTTATGATTTGCA
ATCAACAACCGACTAGGGTATTCATAGAGA|GCAGCGACGAAACGCGATATTCGCAGCATT
TTGCACGAGTGCTAGATGACACTATTCACG|CTAAGCTTGTAAGCATAATCTAACATTGCA
CACGAGTGCTAGACGAGTCTAAGCTTGTAA|GATACACCTGGTGTTGCTAAATGACACTCG
TTACACACTCGACTTATGATTTGCACGAGT|CTTATGATTTGCACGAGTGCTAGACCCTGC
AGACTCGACTTATGATTTGCACGAGTGCTA|CGAGTGCTAGACGAGTCTAAGCTTGTAAGC
GTAGAATCCAAGATAAATCAATAGTAGAAA|AATGTTGAATTGTTCGAGGGGGTGTGCTCA
TCGTTTGGTGAAGTCGTAACTTGAGTCGGG|AGAATCCAAGATAAATCAATAGTAGAAAGA
CACGAGTGCTAGAGTGCTAGATAGCGAGAA|TGATCGTTTGGTGAAGTCGTAACTTGAGTC
GCTAGAGTGCTAGATAGCGAGAAGCAACCG|TTGGTGAAGTCGTAACTTGAGTCGGGCTAA
AGATGTCTCTAGGGCATCAACAACCGACTA|TACCATGATAAGGGCGCAGCGACGAAACGC
TTGCAAATAGGACTCATGTTGGCACAGCCC|GCTAGATACTCGACTTATGATTTGCACGAG
TGCACGAGTGCTAGAACCCAATCACTACGA|TGGCCCCTGACGTCTACCATATTTCAACCG
GTCGGGCTAAACCACCTACTCTCCCACTCG|GAAAGACCGACTAAAGTAAGGAACTCGACT
GTCAGTTGCAAATAGGACTCATGTTGGCAC|CGAGTGCTAGATACTCGACTTATGATTTGC
GTACGGCGAATGTTGAATTGTTCGAGGGGG|TATGATTTGCACGAGTGCTAGAACTCGACT
GACTTACACACTCGACTTATGATTTGCACG|CGACTTATGATTTGCACGAGTGCTAGACCC
TACCATGATAAGGGCGCAGCGACGAAACGC|TCGAGGGGGCTTCGCCCAGCCAGCTCGATG
ACATGAATGTGATCGTTTGGTGAAGTCGTA|TGAAGCGAATGTAGAATCCAAGATAAATCA
TCGACTTATGATTTGCACGAGTGCTAGAGT|GGTTGGACATGAATGTGATCGTTTGGTGAA
CCTGCAGATCGCGCTGAGTCCTTGTACGGC|TCTATGGACTTACACACTCGACTTATGATT
ACGAGTGCTAGACCCTGCAGATGTCGATCA|GTCCAACAGGTTGTGGTATCCTAGAGTGAG
ACTCGACTTATGATTTGCACGAGTGCTAGA|GCAAATAGGACTCATGTTGGCACAGCCCTG
TTGCACGAGTGCTAGAACTCGACTTATGAT|TAGACCCTGCAGATGTCGATCACAGACCGT
CGCGATACACCTGGTGTTGCTAAATGACAC|CCATGACTCGACTTATGATTTGCACGAGTG
GATTTGCACGAGTGCTAGAGTGCTAGATAG|TGAATGTGATCGTTTGGTGAAGTCGTAACT
TAAACCACCTACTCTCCCACTCGACTTATG|CGACTAAAGTAAGGAACTCGACTTATGATT
GGCTAAACCACCTACTCTCCCACTCGACTT|GACCGACTAAAGTAAGGAACTCGACTTATG
AGATGACACTATTCACGGTATGCCATAACG|CATAATCTAACATTGCATCTCTTTACCAGT
CACCCAGACTCGACTTATGATTTGCACGAG|TTGCACGAGTGCTAGACGAGTCTAAGCTTG
TGCTAGATACTCGACTTATGATTTGCACGA|TAGATCGTATCAATTACAGCTACCTCCTGC
CAAATAGGACTCATGTTGGCACAGCCCTGC|AGATACTCGACTTATGATTTGCACGAGTGC
GACAACTGTGAAGCGAATGTAGAATCCAAG|CTGAGTCCTTGTACGGCGAATGTTGAATTG
CGCGTGTCTGCGCATCTAGGTCAGTTGCAA|ACTCGACTTATGATTTGCACGAGTGCTAGA
AGGACTCATGTTGGCACAGCCCTGCATTGG|CTCGACTTATGATTTGCACGAGTGCTAGAG
GATTTGCACGAGTGCTAGATGACACTATTC|AGTCTAAGCTTGTAAGCATAATCTAACATT
ATCGCCATAAGTTTCACGTACCATGATAAG|CTAGACACTCAGAAACCTTCGAGGGGGCTT
CACGAGTGCTAGAGACAACTGTGAAGCGAA|CCTGCAGATCGCGCTGAGTCCTTGTACGGC
GGTGTCCCTTGAAGGGCTGGAAGGACTCGA|TAGAGAACGAGGATGTTAGGTTGACGCGAA
ATTTGCACGAGTGCTAGAAGAGAGGTGTCC|TCAACAACCGACTAGGGTATTCATAGAGAA
GGCGCTCTATTAATAACGACCAGACTCGAC|TACACACTGGGTGCGCCGGAGATGTCTCTA
GCCAGCTCGAATGTGCAAGATAATCTTTAC|TGATTTGCACGAGTGCTAGAACCCAATCAC
TAGACACGAACTCGACTTATGATTTGCACG|CCTGCATTGGTGGTTGGACATGAATGTGAT
GCACGAGTGCTAGACCCTGCAGATGTCGAT|ATGTCCAACAGGTTGTGGTATCCTAGAGTG
CGTTTGGTGAAGTCGTAACTTGAGTCGGGC|GAATCCAAGATAAATCAATAGTAGAAAGAC
TGCTAGATAGCGAGAAGCAACCGAATGGTG|AGTCGTAACTTGAGTCGGGCTAAACCACCT
CACGAGTGCTAGATACTCGACTTATGATTT|GAGTGCTAGATCGTATCAATTACAGCTACC
TTATGATTTGCACGAGTGCTAGATCGTATC|GAGTGCTAGATGACACTATTCACGGTATGC
GTGATCGTTTGGTGAAGTCGTAACTTGAGT|ATGTAGAATCCAAGATAAATCAATAGTAGA
GGAAGGACTCGACTTATGATTTGCACGAGT|GGTTGACGCGAATGCCATAGTTGGCCCCTG
CCTTGTACGGCGAATGTTGAATTGTTCGAG|GACTTATGATTTGCACGAGTGCTAGAACTC
TAGAACCCAATCACTACGAGATTACACACT|GTCTACCATATTTCAACCGGGGAATCGCCA
GATAAGGGCGCAGCGACGAAACGCGATATT|GGGCTTCGCCCAGCCAGCTCGATGATTCAA
TATCAACGCTAATAGTGGCTATTGCTGTCT|GCAAGATAATCTTTACGGGTCGGTGGCGCT
TAGAAAGACCGACTAAAGTAAGGAACTCGA|TGCTCACCCAGACTCGACTTATGATTTGCA
TGATTTGACTCGACTTATGATTTGCACGAG|GTCAGTTGCAAATAGGACTCATGTTGGCAC
GTGCTAGATGACACTATTCACGGTATGCCA|GTAAGCATAATCTAACATTGCATCTCTTTA
TGGCTTAACTCGACTTATGATTTGCACGAG|TAATAGTGGCTATTGCTGTCTATATGTCCA
TAGATAGCGAGAAGCAACCGAATGGTGTGA|CGTAACTTGAGTCGGGCTAAACCACCTACT
CTAAGCTTGTAAGCATAATCTAACATTGCA|AAATGACACTCGACTTATGATTTGCACGAG
ACTTATGATTTGCACGAGTGCTAGACGAGT|ACAGACCGTCGCGATACACCTGGTGTTGCT
ACGAGTGCTAGAACTCGACTTATGATTTGC|CCCTGCAGATGTCGATCACAGACCGTCGCG
ATTTGCACGAGTGCTAGATCGTATCAATTA|CTAGATGACACTATTCACGGTATGCCATAA
GAACTCGACTTATGATTTGCACGAGTGCTA|TGGTGGTTGGACATGAATGTGATCGTTTGG
AGTGCTAGACGAGTCTAAGCTTGTAAGCAT|CACCTGGTGTTGCTAAATGACACTCGACTT
ATGATTTGCACGAGTGCTAGACGAGTCTAA|ACCGTCGCGATACACCTGGTGTTGCTAAAT
TGATTTGCACGAGTGCTAGAGTGCTAGATA|ATGAATGTGATCGTTTGGTGAAGTCGTAAC
ATTTGCACGAGTGCTAGATACTCGACTTAT|TGCACGAGTGCTAGATCGTATCAATTACAG
TGAGTCGGGCTAAACCACCTACTCTCCCAC|GTAGAAAGACCGACTAAAGTAAGGAACTCG
TGATTTGCACGAGTGCTAGATGACACTATT|GAGTCTAAGCTTGTAAGCATAATCTAACAT
CAGACTCGACTTATGATTTGCACGAGTGCT|GATGTCTCTAGGGCATCAACAACCGACTAG
ATGTTGGCACAGCCCTGCATTGGTGGTTGG|TATGATTTGCACGAGTGCTAGAGACAACTG
CGAATGCCATAGTTGGCCCCTGACGTCTAC|AGCTCATAATCGGTTCGTGTATTCGCCAAA
TGACTCGACTTATGATTTGCACGAGTGCTA|TTGCAAATAGGACTCATGTTGGCACAGCCC
ACTCGACTTATGATTTGCACGAGTGCTAGA|AGTGCTAGACGAGTCTAAGCTTGTAAGCAT
ATTTCAACCGGGGAATCGCCATAAGTTTCA|ACACAGAGGGGTTACTAGACACTCAGAAAC
CTAGATCGTATCAATTACAGCTACCTCCTG|TTCACGGTATGCCATAACGATTTCCCTCTA
CTTATGATTTGCACGAGTGCTAGAACTCGA|AATGGTGTGAATGGACGCGTGTCTGCGCAT
ATGTAGAATCCAAGATAAATCAATAGTAGA|CGAATGTTGAATTGTTCGAGGGGGTGTGCT
GAGTGCTAGAACCCAATCACTACGAGATTA|CCTGACGTCTACCATATTTCAACCGGGGAA
AGAGAACGAGGATGTTAGGTTGACGCGAAT|GCATTGCCCTATACATTCTACCGTGAGCTC
TCGACTTATGATTTGACTCGACTTATGATT|GCATCTAGGTCAGTTGCAAATAGGACTCAT
GCACGAGTGCTAGACGAGTCTAAGCTTGTA|CGATACACCTGGTGTTGCTAAATGACACTC
AGGTTGTGGTATCCTAGAGTGAGGGTGATA|GACCAGACTCGACTTATGATTTGCACGAGT
CTTTACGGGTCGGTGGCGCTCTATTAATAA|AATCACTACGAGATTACACACTGGGTGCGC
CGTGTCTGCGCATCTAGGTCAGTTGCAAAT|TCGACTTATGATTTGCACGAGTGCTAGATA
CTTATGATTTGCACGAGTGCTAGACGAGTC|CAGACCGTCGCGATACACCTGGTGTTGCTA
GGTCGGTGGCGCTCTATTAATAACGACCAG|ACGAGATTACACACTGGGTGCGCCGGAGAT
TAATAACGACCAGACTCGACTTATGATTTG|GTGCGCCGGAGATGTCTCTAGGGCATCAAC
GGACGCGTGTCTGCGCATCTAGGTCAGTTG|CCCACTCGACTTATGATTTGCACGAGTGCT
ACCTACTCTCCCACTCGACTTATGATTTGC|AAGTAAGGAACTCGACTTATGATTTGCACG
TAGGTCAGTTGCAAATAGGACTCATGTTGG|GCACGAGTGCTAGATACTCGACTTATGATT
AGATCGTATCAATTACAGCTACCTCCTGCA|CACGGTATGCCATAACGATTTCCCTCTATG
GAGTGCTAGAGTGCTAGATAGCGAGAAGCA|TCGTTTGGTGAAGTCGTAACTTGAGTCGGG
ACACGAACTCGACTTATGATTTGCACGAGT|GCATTGGTGGTTGGACATGAATGTGATCGT
GTCGCGATACACCTGGTGTTGCTAAATGAC|AACCATGACTCGACTTATGATTTGCACGAG
TAGAATCCAAGATAAATCAATAGTAGAAAG|ATGTTGAATTGTTCGAGGGGGTGTGCTCAC
GATTACACACTGGGTGCGCCGGAGATGTCT|GGGAATCGCCATAAGTTTCACGTACCATGA
TGATTTGCACGAGTGCTAGAAGACTAGACG|CCCTTGAAGGGCTGGAAGGACTCGACTTAT
ACCGAATGGTGTGAATGGACGCGTGTCTGC|CTAAACCACCTACTCTCCCACTCGACTTAT
GTATCAATTACAGCTACCTCCTGCAGATCG|TATGCCATAACGATTTCCCTCTATGGACTT
CACTATTCACGGTATGCCATAACGATTTCC|CTAACATTGCATCTCTTTACCAGTGGTTGG
CTATTAATAACGACCAGACTCGACTTATGA|CTGGGTGCGCCGGAGATGTCTCTAGGGCAT
TGATTTGCACGAGTGCTAGACCCTGCAGAT|GTCTATATGTCCAACAGGTTGTGGTATCCT
TGACGCGAATGCCATAGTTGGCCCCTGACG|CCGTGAGCTCATAATCGGTTCGTGTATTCG
CACTCGACTTATGATTTGCACGAGTGCTAG|TCGACTTATGATTTGCACGAGTGCTAGATC
CTCGACTTATGATTTGCACGAGTGCTAGAC|GCTATTGCTGTCTATATGTCCAACAGGTTG
GAGTGCTAGATATCAACGCTAATAGTGGCT|GCTCGAATGTGCAAGATAATCTTTACGGGT
AATGTTGAATTGTTCGAGGGGGTGTGCTCA|GCACGAGTGCTAGAACTCGACTTATGATTT
ATCGTTTGGTGAAGTCGTAACTTGAGTCGG|TAGAATCCAAGATAAATCAATAGTAGAAAG
CTCTTTACCAGTGGTTGGCTTAACTCGACT|GCTAGATATCAACGCTAATAGTGGCTATTG
GGACATGAATGTGATCGTTTGGTGAAGTCG|TGTGAAGCGAATGTAGAATCCAAGATAAAT
CGCTCTATTAATAACGACCAGACTCGACTT|CACACTGGGTGCGCCGGAGATGTCTCTAGG
TCTATTAATAACGACCAGACTCGACTTATG|ACTGGGTGCGCCGGAGATGTCTCTAGGGCA
TATGGACTTACACACTCGACTTATGATTTG|AACTCGACTTATGATTTGCACGAGTGCTAG
TGATTTGCACGAGTGCTAGATACTCGACTT|TTTGCACGAGTGCTAGATCGTATCAATTAC
CATGTTGGCACAGCCCTGCATTGGTGGTTG|TTATGATTTGCACGAGTGCTAGAGACAACT
AAATAGGACTCATGTTGGCACAGCCCTGCA|GATACTCGACTTATGATTTGCACGAGTGCT
CAACCGAATGGTGTGAATGGACGCGTGTCT|GGCTAAACCACCTACTCTCCCACTCGACTT
ACTTATGATTTGCACGAGTGCTAGAACCCA|ATGCCATAGTTGGCCCCTGACGTCTACCAT
CGCATCTAGGTCAGTTGCAAATAGGACTCA|TGATTTGCACGAGTGCTAGATACTCGACTT
AGTTGCAAATAGGACTCATGTTGGCACAGC|GTGCTAGATACTCGACTTATGATTTGCACG
GCGAGAAGCAACCGAATGGTGTGAATGGAC|TTGAGTCGGGCTAAACCACCTACTCTCCCA
GTAAGGAACTCGACTTATGATTTGCACGAG|CTTATGATTTGCACGAGTGCTAGATGACAC
GGTTGGACATGAATGTGATCGTTTGGTGAA|CAACTGTGAAGCGAATGTAGAATCCAAGAT
CGCGCTGAGTCCTTGTACGGCGAATGTTGA|TTACACACTCGACTTATGATTTGCACGAGT
AAGTCGTAACTTGAGTCGGGCTAAACCACC|ATAAATCAATAGTAGAAAGACCGACTAAAG
CAACCGGGGAATCGCCATAAGTTTCACGTA|AGAGGGGTTACTAGACACTCAGAAACCTTC
GGGGAATCGCCATAAGTTTCACGTACCATG|GGTTACTAGACACTCAGAAACCTTCGAGGG
GAGGGTGATAACCATGACTCGACTTATGAT|TTGCACGAGTGCTAGAAGAGAGGTGTCCCT
GTGCAAGATAATCTTTACGGGTCGGTGGCG|GTGCTAGAACCCAATCACTACGAGATTACA
TTGCACGAGTGCTAGATACTCGACTTATGA|CACGAGTGCTAGATCGTATCAATTACAGCT
GTTGCTAAATGACACTCGACTTATGATTTG|TGATTTGCACGAGTGCTAGAAGACTAGACG
TCGGGCTAAACCACCTACTCTCCCACTCGA|AAAGACCGACTAAAGTAAGGAACTCGACTT
CCAGACTCGACTTATGATTTGCACGAGTGC|CACGAGTGCTAGACGAGTCTAAGCTTGTAA
GTGATAACCATGACTCGACTTATGATTTGC|ACGAGTGCTAGAAGAGAGGTGTCCCTTGAA
CGCCGGAGATGTCTCTAGGGCATCAACAAC|TTCACGTACCATGATAAGGGCGCAGCGACG
TGATTTGCACGAGTGCTAGACGAGTCTAAG|CCGTCGCGATACACCTGGTGTTGCTAAATG
TGCTAGAAGACTAGACGCCAGCTCGAATGT|GGAAGGACTCGACTTATGATTTGCACGAGT
GTGCTAGAACTCGACTTATGATTTGACTCG|GCGTGTCTGCGCATCTAGGTCAGTTGCAAA
TGTAGAATCCAAGATAAATCAATAGTAGAA|GAATGTTGAATTGTTCGAGGGGGTGTGCTC
GAGTGCTAGACACGAACTCGACTTATGATT|CACAGCCCTGCATTGGTGGTTGGACATGAA
TGCTAGAACTCGACTTATGATTTGACTCGA|CGTGTCTGCGCATCTAGGTCAGTTGCAAAT
AATGGACGCGTGTCTGCGCATCTAGGTCAG|TCTCCCACTCGACTTATGATTTGCACGAGT
CCATGATAAGGGCGCAGCGACGAAACGCGA|GAGGGGGCTTCGCCCAGCCAGCTCGATGAT
TCAACCGGGGAATCGCCATAAGTTTCACGT|CAGAGGGGTTACTAGACACTCAGAAACCTT
ACTGTGAAGCGAATGTAGAATCCAAGATAA|GTCCTTGTACGGCGAATGTTGAATTGTTCG
TTATGATTTGCACGAGTGCTAGACCCTGCA|GCTGTCTATATGTCCAACAGGTTGTGGTAT
CTAGAAGACTAGACGCCAGCTCGAATGTGC|AAGGACTCGACTTATGATTTGCACGAGTGC
GACGCGAATGCCATAGTTGGCCCCTGACGT|CGTGAGCTCATAATCGGTTCGTGTATTCGC
TGCGCCGGAGATGTCTCTAGGGCATCAACA|GTTTCACGTACCATGATAAGGGCGCAGCGA
CGAGTCTAAGCTTGTAAGCATAATCTAACA|TTGCTAAATGACACTCGACTTATGATTTGC
CTAGAACTCGACTTATGATTTGACTCGACT|TGTCTGCGCATCTAGGTCAGTTGCAAATAG
CTTGTAAGCATAATCTAACATTGCATCTCT|ACACTCGACTTATGATTTGCACGAGTGCTA
TCACTACGAGATTACACACTGGGTGCGCCG|TTTCAACCGGGGAATCGCCATAAGTTTCAC
CTAACATTGCATCTCTTTACCAGTGGTTGG|ATTTGCACGAGTGCTAGATATCAACGCTAA
ATTCATAGAGAACGAGGATGTTAGGTTGAC|TTCGCAGCATTGCCCTATACATTCTACCGT
CCCTGCATTGGTGGTTGGACATGAATGTGA|GAGTGCTAGAGACAACTGTGAAGCGAATGT
CCATATTTCAACCGGGGAATCGCCATAAGT|AAGGACACAGAGGGGTTACTAGACACTCAG
CCTCCTGCAGATCGCGCTGAGTCCTTGTAC|CCCTCTATGGACTTACACACTCGACTTATG
GCTCTATTAATAACGACCAGACTCGACTTA|ACACTGGGTGCGCCGGAGATGTCTCTAGGG
TGCTAAATGACACTCGACTTATGATTTGCA|ATTTGCACGAGTGCTAGAAGACTAGACGCC
TCACCCAGACTCGACTTATGATTTGCACGA|TTTGCACGAGTGCTAGACGAGTCTAAGCTT
AAGTAAGGAACTCGACTTATGATTTGCACG|GACTTATGATTTGCACGAGTGCTAGATGAC
GATACTCGACTTATGATTTGCACGAGTGCT|CGTATCAATTACAGCTACCTCCTGCAGATC
AGAACTCGACTTATGATTTGCACGAGTGCT|TGTCGATCACAGACCGTCGCGATACACCTG
ACGAGTGCTAGAACTCGACTTATGATTTGA|GGACGCGTGTCTGCGCATCTAGGTCAGTTG
GGTATGCCATAACGATTTCCCTCTATGGAC|ATCTCTTTACCAGTGGTTGGCTTAACTCGA
AGTGCTAGATACTCGACTTATGATTTGCAC|GCTAGATCGTATCAATTACAGCTACCTCCT
CGTAACTTGAGTCGGGCTAAACCACCTACT|ATCAATAGTAGAAAGACCGACTAAAGTAAG
TATCCTAGAGTGAGGGTGATAACCATGACT|CGACTTATGATTTGCACGAGTGCTAGAAGA
CGAGTGCTAGAGACAACTGTGAAGCGAATG|TGCAGATCGCGCTGAGTCCTTGTACGGCGA
AAGTTTCACGTACCATGATAAGGGCGCAGC|TCAGAAACCTTCGAGGGGGCTTCGCCCAGC
AATAGGACTCATGTTGGCACAGCCCTGCAT|ATACTCGACTTATGATTTGCACGAGTGCTA
CGACTTATGATTTGCACGAGTGCTAGACCC|TATTGCTGTCTATATGTCCAACAGGTTGTG
TTGCACGAGTGCTAGAACTCGACTTATGAT|GAATGGACGCGTGTCTGCGCATCTAGGTCA
ACTCGACTTATGATTTGCACGAGTGCTAGA|GGCTATTGCTGTCTATATGTCCAACAGGTT
GATTTGCACGAGTGCTAGACCCTGCAGATG|TCTATATGTCCAACAGGTTGTGGTATCCTA
ATGTTGAATTGTTCGAGGGGGTGTGCTCAC|CACGAGTGCTAGAACTCGACTTATGATTTG
ACCGACTAGGGTATTCATAGAGAACGAGGA|CGAAACGCGATATTCGCAGCATTGCCCTAT
AACCCAATCACTACGAGATTACACACTGGG|TACCATATTTCAACCGGGGAATCGCCATAA
ATGACTCGACTTATGATTTGCACGAGTGCT|AGAAGAGAGGTGTCCCTTGAAGGGCTGGAA
AGATTACACACTGGGTGCGCCGGAGATGTC|GGGGAATCGCCATAAGTTTCACGTACCATG
GGTGATAACCATGACTCGACTTATGATTTG|CACGAGTGCTAGAAGAGAGGTGTCCCTTGA
AAATGACACTCGACTTATGATTTGCACGAG|GCACGAGTGCTAGAAGACTAGACGCCAGCT
ATAGGACTCATGTTGGCACAGCCCTGCATT|TACTCGACTTATGATTTGCACGAGTGCTAG
CGTACCATGATAAGGGCGCAGCGACGAAAC|CTTCGAGGGGGCTTCGCCCAGCCAGCTCGA
GCTAGATCGTATCAATTACAGCTACCTCCT|ATTCACGGTATGCCATAACGATTTCCCTCT
AGACCGACTAAAGTAAGGAACTCGACTTAT|ACCCAGACTCGACTTATGATTTGCACGAGT
CCCTCTATGGACTTACACACTCGACTTATG|GGCTTAACTCGACTTATGATTTGCACGAGT
CGAGTGCTAGACCCTGCAGATGTCGATCAC|TCCAACAGGTTGTGGTATCCTAGAGTGAGG
TAACATTGCATCTCTTTACCAGTGGTTGGC|TTTGCACGAGTGCTAGATATCAACGCTAAT
TTTGACTCGACTTATGATTTGCACGAGTGC|AGTTGCAAATAGGACTCATGTTGGCACAGC
TATGATTTGCACGAGTGCTAGATACTCGAC|GATTTGCACGAGTGCTAGATCGTATCAATT
GCAGATCGCGCTGAGTCCTTGTACGGCGAA|ATGGACTTACACACTCGACTTATGATTTGC
GAATGTGCAAGATAATCTTTACGGGTCGGT|ACGAGTGCTAGAACCCAATCACTACGAGAT
CTAGGTCAGTTGCAAATAGGACTCATGTTG|TGCACGAGTGCTAGATACTCGACTTATGAT
GTTGTGGTATCCTAGAGTGAGGGTGATAAC|CCAGACTCGACTTATGATTTGCACGAGTGC
GTTGGCACAGCCCTGCATTGGTGGTTGGAC|TGATTTGCACGAGTGCTAGAGACAACTGTG
GAGTGCTAGATGACACTATTCACGGTATGC|TTGTAAGCATAATCTAACATTGCATCTCTT
GAATGTTGAATTGTTCGAGGGGGTGTGCTC|TGCACGAGTGCTAGAACTCGACTTATGATT
TGAATGGACGCGTGTCTGCGCATCTAGGTC|ACTCTCCCACTCGACTTATGATTTGCACGA
ACGAGTGCTAGAAGAGAGGTGTCCCTTGAA|ACCGACTAGGGTATTCATAGAGAACGAGGA
ATAATCTTTACGGGTCGGTGGCGCTCTATT|AACCCAATCACTACGAGATTACACACTGGG
CACAGCCCTGCATTGGTGGTTGGACATGAA|TGCACGAGTGCTAGAGACAACTGTGAAGCG
CTAAAGTAAGGAACTCGACTTATGATTTGC|CTCGACTTATGATTTGCACGAGTGCTAGAT
GGTGAAGTCGTAACTTGAGTCGGGCTAAAC|CAAGATAAATCAATAGTAGAAAGACCGACT
ATTTGCACGAGTGCTAGAGTGCTAGATAGC|GAATGTGATCGTTTGGTGAAGTCGTAACTT
AGTCGTAACTTGAGTCGGGCTAAACCACCT|TAAATCAATAGTAGAAAGACCGACTAAAGT
AGTGGTTGGCTTAACTCGACTTATGATTTG|CAACGCTAATAGTGGCTATTGCTGTCTATA
ACCATGACTCGACTTATGATTTGCACGAGT|GCTAGAAGAGAGGTGTCCCTTGAAGGGCTG
GTGCTAGAACCCAATCACTACGAGATTACA|TGACGTCTACCATATTTCAACCGGGGAATC
GTGGTATCCTAGAGTGAGGGTGATAACCAT|GACTCGACTTATGATTTGCACGAGTGCTAG
GCAACCGAATGGTGTGAATGGACGCGTGTC|GGGCTAAACCACCTACTCTCCCACTCGACT
TCGACTTATGATTTGCACGAGTGCTAGACA|AAATAGGACTCATGTTGGCACAGCCCTGCA
TCGTAACTTGAGTCGGGCTAAACCACCTAC|AATCAATAGTAGAAAGACCGACTAAAGTAA
GTAAGCATAATCTAACATTGCATCTCTTTA|CTCGACTTATGATTTGCACGAGTGCTAGAT
AGTCCTTGTACGGCGAATGTTGAATTGTTC|CTCGACTTATGATTTGCACGAGTGCTAGAA
GGAGATGTCTCTAGGGCATCAACAACCGAC|CGTACCATGATAAGGGCGCAGCGACGAAAC
AGGGGGTGTGCTCACCCAGACTCGACTTAT|TCGACTTATGATTTGCACGAGTGCTAGACG
CGCAGCGACGAAACGCGATATTCGCAGCAT|CCCAGCCAGCTCGATGATTCAACGTAGAGC
ATAGTGGCTATTGCTGTCTATATGTCCAAC|TTTACGGGTCGGTGGCGCTCTATTAATAAC
TACCTCCTGCAGATCGCGCTGAGTCCTTGT|TTCCCTCTATGGACTTACACACTCGACTTA
GAATCGCCATAAGTTTCACGTACCATGATA|TACTAGACACTCAGAAACCTTCGAGGGGGC
GTATCCTAGAGTGAGGGTGATAACCATGAC|TCGACTTATGATTTGCACGAGTGCTAGAAG
TTGCACGAGTGCTAGACCCTGCAGATGTCG|ATATGTCCAACAGGTTGTGGTATCCTAGAG
ACGTCTACCATATTTCAACCGGGGAATCGC|TCGCCAAAAGGACACAGAGGGGTTACTAGA
TTGACGCGAATGCCATAGTTGGCCCCTGAC|ACCGTGAGCTCATAATCGGTTCGTGTATTC
GGCTATTGCTGTCTATATGTCCAACAGGTT|GGGTCGGTGGCGCTCTATTAATAACGACCA
TATTGCTGTCTATATGTCCAACAGGTTGTG|TCGGTGGCGCTCTATTAATAACGACCAGAC
GGGCATCAACAACCGACTAGGGTATTCATA|GGGCGCAGCGACGAAACGCGATATTCGCAG
GAACGAGGATGTTAGGTTGACGCGAATGCC|TTGCCCTATACATTCTACCGTGAGCTCATA
GACTTATGATTTGCACGAGTGCTAGACCCT|ATTGCTGTCTATATGTCCAACAGGTTGTGG
TCTCTAGGGCATCAACAACCGACTAGGGTA|TGATAAGGGCGCAGCGACGAAACGCGATAT
TCGACTTATGATTTGCACGAGTGCTAGAAC|TTGCACGAGTGCTAGACCCTGCAGATGTCG
CTATGGACTTACACACTCGACTTATGATTT|TAACTCGACTTATGATTTGCACGAGTGCTA
AGAACCCAATCACTACGAGATTACACACTG|TCTACCATATTTCAACCGGGGAATCGCCAT
TGGTGGTTGGACATGAATGTGATCGTTTGG|GAGACAACTGTGAAGCGAATGTAGAATCCA
CATATTTCAACCGGGGAATCGCCATAAGTT|AGGACACAGAGGGGTTACTAGACACTCAGA
CGACTTATGATTTGCACGAGTGCTAGACGA|TCACAGACCGTCGCGATACACCTGGTGTTG
CTAGATAGCGAGAAGCAACCGAATGGTGTG|TCGTAACTTGAGTCGGGCTAAACCACCTAC
ATGTCCAACAGGTTGTGGTATCCTAGAGTG|ATTAATAACGACCAGACTCGACTTATGATT
ACTCGACTTATGATTTGCACGAGTGCTAGA|TGCTAGAAGACTAGACGCCAGCTCGAATGT
GATCGTTTGGTGAAGTCGTAACTTGAGTCG|GTAGAATCCAAGATAAATCAATAGTAGAAA
TGGTTGGCTTAACTCGACTTATGATTTGCA|ACGCTAATAGTGGCTATTGCTGTCTATATG
CTCGACTTATGATTTGCACGAGTGCTAGAG|TGGTTGGACATGAATGTGATCGTTTGGTGA
GAAGGACTCGACTTATGATTTGCACGAGTG|GTTGACGCGAATGCCATAGTTGGCCCCTGA
TTGGTGGTTGGACATGAATGTGATCGTTTG|AGAGACAACTGTGAAGCGAATGTAGAATCC
TTGCACGAGTGCTAGAAGACTAGACGCCAG|TGAAGGGCTGGAAGGACTCGACTTATGATT
ATACTCGACTTATGATTTGCACGAGTGCTA|GTATCAATTACAGCTACCTCCTGCAGATCG
ATTTGCACGAGTGCTAGATGACACTATTCA|GTCTAAGCTTGTAAGCATAATCTAACATTG
TTAATAACGACCAGACTCGACTTATGATTT|GGTGCGCCGGAGATGTCTCTAGGGCATCAA
CCGAATGGTGTGAATGGACGCGTGTCTGCG|TAAACCACCTACTCTCCCACTCGACTTATG
CCTGACGTCTACCATATTTCAACCGGGGAA|GTATTCGCCAAAAGGACACAGAGGGGTTAC
ATAACGACCAGACTCGACTTATGATTTGCA|GCGCCGGAGATGTCTCTAGGGCATCAACAA
CGTCGCGATACACCTGGTGTTGCTAAATGA|TAACCATGACTCGACTTATGATTTGCACGA
TACTCTCCCACTCGACTTATGATTTGCACG|TAAGGAACTCGACTTATGATTTGCACGAGT
GAATGGTGTGAATGGACGCGTGTCTGCGCA|AACCACCTACTCTCCCACTCGACTTATGAT
TTACACACTGGGTGCGCCGGAGATGTCTCT|GAATCGCCATAAGTTTCACGTACCATGATA
CAACCGACTAGGGTATTCATAGAGAACGAG|GACGAAACGCGATATTCGCAGCATTGCCCT
AATTACAGCTACCTCCTGCAGATCGCGCTG|CATAACGATTTCCCTCTATGGACTTACACA
GTGGTTGGACATGAATGTGATCGTTTGGTG|GACAACTGTGAAGCGAATGTAGAATCCAAG
GTGTCCCTTGAAGGGCTGGAAGGACTCGAC|AGAGAACGAGGATGTTAGGTTGACGCGAAT
AGATAATCTTTACGGGTCGGTGGCGCTCTA|AGAACCCAATCACTACGAGATTACACACTG
GGTCAGTTGCAAATAGGACTCATGTTGGCA|ACGAGTGCTAGATACTCGACTTATGATTTG
CAATTACAGCTACCTCCTGCAGATCGCGCT|CCATAACGATTTCCCTCTATGGACTTACAC
CTAGAACCCAATCACTACGAGATTACACAC|CGTCTACCATATTTCAACCGGGGAATCGCC
GCATCTCTTTACCAGTGGTTGGCTTAACTC|GAGTGCTAGATATCAACGCTAATAGTGGCT
CGAGTGCTAGAGTGCTAGATAGCGAGAAGC|ATCGTTTGGTGAAGTCGTAACTTGAGTCGG
CACGAGTGCTAGATATCAACGCTAATAGTG|CCAGCTCGAATGTGCAAGATAATCTTTACG
CCATGACTCGACTTATGATTTGCACGAGTG|CTAGAAGAGAGGTGTCCCTTGAAGGGCTGG
ACTTATGATTTGCACGAGTGCTAGATACTC|TATGATTTGCACGAGTGCTAGATCGTATCA
CACGTACCATGATAAGGGCGCAGCGACGAA|ACCTTCGAGGGGGCTTCGCCCAGCCAGCTC
AGGGCATCAACAACCGACTAGGGTATTCAT|AGGGCGCAGCGACGAAACGCGATATTCGCA
TAGAGTGCTAGATAGCGAGAAGCAACCGAA|GGTGAAGTCGTAACTTGAGTCGGGCTAAAC
AGAGGTGTCCCTTGAAGGGCTGGAAGGACT|TCATAGAGAACGAGGATGTTAGGTTGACGC
ACTCGACTTATGATTTGCACGAGTGCTAGA|AGAGAGGTGTCCCTTGAAGGGCTGGAAGGA
GGTGTGCTCACCCAGACTCGACTTATGATT|CTTATGATTTGCACGAGTGCTAGACGAGTC
ACTCGACTTATGATTTGCACGAGTGCTAGA|GTCTCTAGGGCATCAACAACCGACTAGGGT
ACTCGACTTATGATTTGCACGAGTGCTAGA|ATCAATTACAGCTACCTCCTGCAGATCGCG
GAGTGCTAGATAGCGAGAAGCAACCGAATG|TGAAGTCGTAACTTGAGTCGGGCTAAACCA
CTGTCTATATGTCCAACAGGTTGTGGTATC|GGCGCTCTATTAATAACGACCAGACTCGAC
GAGTCTAAGCTTGTAAGCATAATCTAACAT|TGCTAAATGACACTCGACTTATGATTTGCA
GCACGAGTGCTAGAACTCGACTTATGATTT|GACCCTGCAGATGTCGATCACAGACCGTCG
TCCTGCAGATCGCGCTGAGTCCTTGTACGG|CTCTATGGACTTACACACTCGACTTATGAT
TAGATATCAACGCTAATAGTGGCTATTGCT|ATGTGCAAGATAATCTTTACGGGTCGGTGG
ATTGCTGTCTATATGTCCAACAGGTTGTGG|CGGTGGCGCTCTATTAATAACGACCAGACT
CGAGGGGGTGTGCTCACCCAGACTCGACTT|ACTCGACTTATGATTTGCACGAGTGCTAGA
CGAGTGCTAGAAGACTAGACGCCAGCTCGA|GGCTGGAAGGACTCGACTTATGATTTGCAC
AGTTGGCCCCTGACGTCTACCATATTTCAA|CGGTTCGTGTATTCGCCAAAAGGACACAGA
AGACTAGACGCCAGCTCGAATGTGCAAGAT|CTCGACTTATGATTTGCACGAGTGCTAGAA
CACACTGGGTGCGCCGGAGATGTCTCTAGG|TCGCCATAAGTTTCACGTACCATGATAAGG
TAGAGAACGAGGATGTTAGGTTGACGCGAA|AGCATTGCCCTATACATTCTACCGTGAGCT
GACTTATGATTTGCACGAGTGCTAGAGTGC|TTGGACATGAATGTGATCGTTTGGTGAAGT
TATGATTTGCACGAGTGCTAGAACTCGACT|TGGTGTGAATGGACGCGTGTCTGCGCATCT
TCGCGATACACCTGGTGTTGCTAAATGACA|ACCATGACTCGACTTATGATTTGCACGAGT
GTATGCCATAACGATTTCCCTCTATGGACT|TCTCTTTACCAGTGGTTGGCTTAACTCGAC
CAGATGTCGATCACAGACCGTCGCGATACA|ATCCTAGAGTGAGGGTGATAACCATGACTC
TGGACTTACACACTCGACTTATGATTTGCA|CTCGACTTATGATTTGCACGAGTGCTAGAC
CGAATGGTGTGAATGGACGCGTGTCTGCGC|AAACCACCTACTCTCCCACTCGACTTATGA
ACTCGACTTATGATTTGCACGAGTGCTAGA|TTTGCACGAGTGCTAGATGACACTATTCAC
CATAGAGAACGAGGATGTTAGGTTGACGCG|GCAGCATTGCCCTATACATTCTACCGTGAG
GCGCTGAGTCCTTGTACGGCGAATGTTGAA|TACACACTCGACTTATGATTTGCACGAGTG
TGGCTATTGCTGTCTATATGTCCAACAGGT|CGGGTCGGTGGCGCTCTATTAATAACGACC
ACTTATGATTTGCACGAGTGCTAGACCCTG|TTGCTGTCTATATGTCCAACAGGTTGTGGT
TAAGGGCGCAGCGACGAAACGCGATATTCG|GCTTCGCCCAGCCAGCTCGATGATTCAACG
CGACTTATGATTTGCACGAGTGCTAGATGA|GCTAGACGAGTCTAAGCTTGTAAGCATAAT
TTGGTGAAGTCGTAACTTGAGTCGGGCTAA|TCCAAGATAAATCAATAGTAGAAAGACCGA
TATGATTTGCACGAGTGCTAGAACCCAATC|CCATAGTTGGCCCCTGACGTCTACCATATT
TGTGAATGGACGCGTGTCTGCGCATCTAGG|CTACTCTCCCACTCGACTTATGATTTGCAC
GAAGAGAGGTGTCCCTTGAAGGGCTGGAAG|GTATTCATAGAGAACGAGGATGTTAGGTTG
TGGTGTTGCTAAATGACACTCGACTTATGA|CTTATGATTTGCACGAGTGCTAGAAGACTA
TTGCACGAGTGCTAGAAGAGAGGTGTCCCT|AACAACCGACTAGGGTATTCATAGAGAACG
TAGAACTCGACTTATGATTTGACTCGACTT|GTCTGCGCATCTAGGTCAGTTGCAAATAGG
CTCGACTTATGATTTGCACGAGTGCTAGAC|GATCACAGACCGTCGCGATACACCTGGTGT
TGTGGTATCCTAGAGTGAGGGTGATAACCA|AGACTCGACTTATGATTTGCACGAGTGCTA
ATGATTTGCACGAGTGCTAGATCGTATCAA|GTGCTAGATGACACTATTCACGGTATGCCA
CTTGAGTCGGGCTAAACCACCTACTCTCCC|TAGTAGAAAGACCGACTAAAGTAAGGAACT
AACTCGACTTATGATTTGCACGAGTGCTAG|TGGCTATTGCTGTCTATATGTCCAACAGGT
GACTCGACTTATGATTTGCACGAGTGCTAG|TGTCTCTAGGGCATCAACAACCGACTAGGG
TGCTAGAAGAGAGGTGTCCCTTGAAGGGCT|CTAGGGTATTCATAGAGAACGAGGATGTTA
CTAGAGACAACTGTGAAGCGAATGTAGAAT|TCGCGCTGAGTCCTTGTACGGCGAATGTTG
GGGGGTGTGCTCACCCAGACTCGACTTATG|CGACTTATGATTTGCACGAGTGCTAGACGA
GAACTCGACTTATGATTTGCACGAGTGCTA|GTCGATCACAGACCGTCGCGATACACCTGG
AGGGCGCAGCGACGAAACGCGATATTCGCA|TTCGCCCAGCCAGCTCGATGATTCAACGTA
CCGGAGATGTCTCTAGGGCATCAACAACCG|CACGTACCATGATAAGGGCGCAGCGACGAA
ACAGCCCTGCATTGGTGGTTGGACATGAAT|GCACGAGTGCTAGAGACAACTGTGAAGCGA
AATAGTGGCTATTGCTGTCTATATGTCCAA|CTTTACGGGTCGGTGGCGCTCTATTAATAA
GTGCTAGATATCAACGCTAATAGTGGCTAT|TCGAATGTGCAAGATAATCTTTACGGGTCG
CTAGACGCCAGCTCGAATGTGCAAGATAAT|GACTTATGATTTGCACGAGTGCTAGAACCC
GTTGACGCGAATGCCATAGTTGGCCCCTGA|TACCGTGAGCTCATAATCGGTTCGTGTATT
TGTTGAATTGTTCGAGGGGGTGTGCTCACC|ACGAGTGCTAGAACTCGACTTATGATTTGC
ACAGGTTGTGGTATCCTAGAGTGAGGGTGA|ACGACCAGACTCGACTTATGATTTGCACGA
AGGAACTCGACTTATGATTTGCACGAGTGC|ATGATTTGCACGAGTGCTAGATGACACTAT
GTAGAAAGACCGACTAAAGTAAGGAACTCG|GTGCTCACCCAGACTCGACTTATGATTTGC
TGCAGATGTCGATCACAGACCGTCGCGATA|GTATCCTAGAGTGAGGGTGATAACCATGAC
GACCCTGCAGATGTCGATCACAGACCGTCG|TTGTGGTATCCTAGAGTGAGGGTGATAACC
CTAGGGCATCAACAACCGACTAGGGTATTC|TAAGGGCGCAGCGACGAAACGCGATATTCG
ACCACCTACTCTCCCACTCGACTTATGATT|CTAAAGTAAGGAACTCGACTTATGATTTGC
GAGATGTCTCTAGGGCATCAACAACCGACT|GTACCATGATAAGGGCGCAGCGACGAAACG
TGTACGGCGAATGTTGAATTGTTCGAGGGG|TTATGATTTGCACGAGTGCTAGAACTCGAC
GAACTCGACTTATGATTTGACTCGACTTAT|CTGCGCATCTAGGTCAGTTGCAAATAGGAC
TATTTCAACCGGGGAATCGCCATAAGTTTC|GACACAGAGGGGTTACTAGACACTCAGAAA
ACCCAGACTCGACTTATGATTTGCACGAGT|TGCACGAGTGCTAGACGAGTCTAAGCTTGT
ATAGAGAACGAGGATGTTAGGTTGACGCGA|CAGCATTGCCCTATACATTCTACCGTGAGC
TCGATCACAGACCGTCGCGATACACCTGGT|GAGTGAGGGTGATAACCATGACTCGACTTA
TTGCACGAGTGCTAGAGTGCTAGATAGCGA|ATGTGATCGTTTGGTGAAGTCGTAACTTGA
GTGCTAGACCCTGCAGATGTCGATCACAGA|AACAGGTTGTGGTATCCTAGAGTGAGGGTG
AAACTCGACTTATGATTTGCACGAGTGCTA|AGCAACCGAATGGTGTGAATGGACGCGTGT
AAGGGCGCAGCGACGAAACGCGATATTCGC|CTTCGCCCAGCCAGCTCGATGATTCAACGT
ACTTATGATTTGCACGAGTGCTAGAACTCG|GAATGGTGTGAATGGACGCGTGTCTGCGCA
GGAACTCGACTTATGATTTGCACGAGTGCT|TGATTTGCACGAGTGCTAGATGACACTATT
TTTGCACGAGTGCTAGAACTCGACTTATGA|TGAATGGACGCGTGTCTGCGCATCTAGGTC
TACACACTCGACTTATGATTTGCACGAGTG|TTATGATTTGCACGAGTGCTAGACCCTGCA
CGACTTATGATTTGCACGAGTGCTAGATAT|TAGAAGACTAGACGCCAGCTCGAATGTGCA
TTGCACGAGTGCTAGAACCCAATCACTACG|TTGGCCCCTGACGTCTACCATATTTCAACC
CACAGACCGTCGCGATACACCTGGTGTTGC|AGGGTGATAACCATGACTCGACTTATGATT
AATCACTACGAGATTACACACTGGGTGCGC|TATTTCAACCGGGGAATCGCCATAAGTTTC
GGTATCCTAGAGTGAGGGTGATAACCATGA|CTCGACTTATGATTTGCACGAGTGCTAGAA
TTTGCACGAGTGCTAGAAGAGAGGTGTCCC|CAACAACCGACTAGGGTATTCATAGAGAAC
AGTGCTAGAACCCAATCACTACGAGATTAC|CTGACGTCTACCATATTTCAACCGGGGAAT
TTGGCTTAACTCGACTTATGATTTGCACGA|CTAATAGTGGCTATTGCTGTCTATATGTCC
GCACGAGTGCTAGAACTCGACTTATGATTT|ATGGACGCGTGTCTGCGCATCTAGGTCAGT
TCAACGCTAATAGTGGCTATTGCTGTCTAT|AAGATAATCTTTACGGGTCGGTGGCGCTCT
CTAATAGTGGCTATTGCTGTCTATATGTCC|ATCTTTACGGGTCGGTGGCGCTCTATTAAT
GGTGGCGCTCTATTAATAACGACCAGACTC|GATTACACACTGGGTGCGCCGGAGATGTCT
GTGCTAGAGACAACTGTGAAGCGAATGTAG|AGATCGCGCTGAGTCCTTGTACGGCGAATG
GATCGCGCTGAGTCCTTGTACGGCGAATGT|GACTTACACACTCGACTTATGATTTGCACG
GCATCTAGGTCAGTTGCAAATAGGACTCAT|GATTTGCACGAGTGCTAGATACTCGACTTA
TTATGATTTGCACGAGTGCTAGAAGACTAG|TGTCCCTTGAAGGGCTGGAAGGACTCGACT
AACCGGGGAATCGCCATAAGTTTCACGTAC|GAGGGGTTACTAGACACTCAGAAACCTTCG
GAAGTCGTAACTTGAGTCGGGCTAAACCAC|GATAAATCAATAGTAGAAAGACCGACTAAA
ACGAGATTACACACTGGGTGCGCCGGAGAT|ACCGGGGAATCGCCATAAGTTTCACGTACC
AATGGTGTGAATGGACGCGTGTCTGCGCAT|ACCACCTACTCTCCCACTCGACTTATGATT
CACCTACTCTCCCACTCGACTTATGATTTG|AAAGTAAGGAACTCGACTTATGATTTGCAC
TCGAGGGGGTGTGCTCACCCAGACTCGACT|AACTCGACTTATGATTTGCACGAGTGCTAG
ATTTGCACGAGTGCTAGACCCTGCAGATGT|CTATATGTCCAACAGGTTGTGGTATCCTAG
GAATCCAAGATAAATCAATAGTAGAAAGAC|GTTGAATTGTTCGAGGGGGTGTGCTCACCC
GTGTGCTCACCCAGACTCGACTTATGATTT|TTATGATTTGCACGAGTGCTAGACGAGTCT
TGATTTGCACGAGTGCTAGATCGTATCAAT|TGCTAGATGACACTATTCACGGTATGCCAT
TTATGATTTGCACGAGTGCTAGAACCCAAT|GCCATAGTTGGCCCCTGACGTCTACCATAT
TTCACGGTATGCCATAACGATTTCCCTCTA|ATTGCATCTCTTTACCAGTGGTTGGCTTAA
TGAGGGTGATAACCATGACTCGACTTATGA|TTTGCACGAGTGCTAGAAGAGAGGTGTCCC
GAGAACGAGGATGTTAGGTTGACGCGAATG|CATTGCCCTATACATTCTACCGTGAGCTCA
CACTCGACTTATGATTTGCACGAGTGCTAG|GTGCTAGAAGACTAGACGCCAGCTCGAATG
TGAATGTGATCGTTTGGTGAAGTCGTAACT|AGCGAATGTAGAATCCAAGATAAATCAATA
TCCCTTGAAGGGCTGGAAGGACTCGACTTA|GAACGAGGATGTTAGGTTGACGCGAATGCC
TTGTACGGCGAATGTTGAATTGTTCGAGGG|CTTATGATTTGCACGAGTGCTAGAACTCGA
TGCTGTCTATATGTCCAACAGGTTGTGGTA|GTGGCGCTCTATTAATAACGACCAGACTCG
TACCAGTGGTTGGCTTAACTCGACTTATGA|ATATCAACGCTAATAGTGGCTATTGCTGTC
GAGTCGGGCTAAACCACCTACTCTCCCACT|TAGAAAGACCGACTAAAGTAAGGAACTCGA
TCTTTACCAGTGGTTGGCTTAACTCGACTT|CTAGATATCAACGCTAATAGTGGCTATTGC
TGCACGAGTGCTAGACGAGTCTAAGCTTGT|GCGATACACCTGGTGTTGCTAAATGACACT
AATAACGACCAGACTCGACTTATGATTTGC|TGCGCCGGAGATGTCTCTAGGGCATCAACA
TTACCAGTGGTTGGCTTAACTCGACTTATG|GATATCAACGCTAATAGTGGCTATTGCTGT
ATATTTCAACCGGGGAATCGCCATAAGTTT|GGACACAGAGGGGTTACTAGACACTCAGAA
TTATGATTTGCACGAGTGCTAGATACTCGA|TGATTTGCACGAGTGCTAGATCGTATCAAT
CTCCTGCAGATCGCGCTGAGTCCTTGTACG|CCTCTATGGACTTACACACTCGACTTATGA
GTGAATGGACGCGTGTCTGCGCATCTAGGT|TACTCTCCCACTCGACTTATGATTTGCACG
ACTCTCCCACTCGACTTATGATTTGCACGA|AAGGAACTCGACTTATGATTTGCACGAGTG
TGGCACAGCCCTGCATTGGTGGTTGGACAT|ATTTGCACGAGTGCTAGAGACAACTGTGAA
AGGTCAGTTGCAAATAGGACTCATGTTGGC|CACGAGTGCTAGATACTCGACTTATGATTT
ACAACCGACTAGGGTATTCATAGAGAACGA|CGACGAAACGCGATATTCGCAGCATTGCCC
GGGCGCAGCGACGAAACGCGATATTCGCAG|TCGCCCAGCCAGCTCGATGATTCAACGTAG
CACTGGGTGCGCCGGAGATGTCTCTAGGGC|GCCATAAGTTTCACGTACCATGATAAGGGC
TGGACGCGTGTCTGCGCATCTAGGTCAGTT|TCCCACTCGACTTATGATTTGCACGAGTGC
ATGATTTGCACGAGTGCTAGATACTCGACT|ATTTGCACGAGTGCTAGATCGTATCAATTA
GTGCTAGATCGTATCAATTACAGCTACCTC|CTATTCACGGTATGCCATAACGATTTCCCT
AAGCAACCGAATGGTGTGAATGGACGCGTG|TCGGGCTAAACCACCTACTCTCCCACTCGA
ACTGGGTGCGCCGGAGATGTCTCTAGGGCA|CCATAAGTTTCACGTACCATGATAAGGGCG
TTTGCACGAGTGCTAGAGTGCTAGATAGCG|AATGTGATCGTTTGGTGAAGTCGTAACTTG
CTCGACTTATGATTTGCACGAGTGCTAGAG|TCAATTACAGCTACCTCCTGCAGATCGCGC
ACACTGGGTGCGCCGGAGATGTCTCTAGGG|CGCCATAAGTTTCACGTACCATGATAAGGG
GTGAAGTCGTAACTTGAGTCGGGCTAAACC|AAGATAAATCAATAGTAGAAAGACCGACTA
AAGCTTGTAAGCATAATCTAACATTGCATC|ATGACACTCGACTTATGATTTGCACGAGTG
CATGATAAGGGCGCAGCGACGAAACGCGAT|AGGGGGCTTCGCCCAGCCAGCTCGATGATT
CGACTTATGATTTGACTCGACTTATGATTT|CATCTAGGTCAGTTGCAAATAGGACTCATG
GCACGAGTGCTAGAGACAACTGTGAAGCGA|TCCTGCAGATCGCGCTGAGTCCTTGTACGG
ACACTCGACTTATGATTTGCACGAGTGCTA|AGTGCTAGAAGACTAGACGCCAGCTCGAAT
TTGCACGAGTGCTAGACGAGTCTAAGCTTG|CGCGATACACCTGGTGTTGCTAAATGACAC
CTCGAATGTGCAAGATAATCTTTACGGGTC|TGCACGAGTGCTAGAACCCAATCACTACGA
GAGTGCTAGAAGAGAGGTGTCCCTTGAAGG|CGACTAGGGTATTCATAGAGAACGAGGATG
TGCTAGACGAGTCTAAGCTTGTAAGCATAA|CCTGGTGTTGCTAAATGACACTCGACTTAT
CTGTGAAGCGAATGTAGAATCCAAGATAAA|TCCTTGTACGGCGAATGTTGAATTGTTCGA
TGCTCACCCAGACTCGACTTATGATTTGCA|TGATTTGCACGAGTGCTAGACGAGTCTAAG
CTATATGTCCAACAGGTTGTGGTATCCTAG|CTCTATTAATAACGACCAGACTCGACTTAT
AGTGCTAGATAGCGAGAAGCAACCGAATGG|GAAGTCGTAACTTGAGTCGGGCTAAACCAC
GGACTTACACACTCGACTTATGATTTGCAC|TCGACTTATGATTTGCACGAGTGCTAGACC
TGCACGAGTGCTAGATATCAACGCTAATAG|CGCCAGCTCGAATGTGCAAGATAATCTTTA
TTATGATTTGCACGAGTGCTAGAACTCGAC|ATGGTGTGAATGGACGCGTGTCTGCGCATC
TCGACTTATGATTTGCACGAGTGCTAGAAC|CGAATGCCATAGTTGGCCCCTGACGTCTAC
CCGACTAAAGTAAGGAACTCGACTTATGAT|CAGACTCGACTTATGATTTGCACGAGTGCT
GACTTATGATTTGCACGAGTGCTAGATGAC|CTAGACGAGTCTAAGCTTGTAAGCATAATC
ACTTATGATTTGCACGAGTGCTAGACACGA|TAGGACTCATGTTGGCACAGCCCTGCATTG
CATAGTTGGCCCCTGACGTCTACCATATTT|AATCGGTTCGTGTATTCGCCAAAAGGACAC
CCATAACGATTTCCCTCTATGGACTTACAC|TTACCAGTGGTTGGCTTAACTCGACTTATG
CGAGTGCTAGATATCAACGCTAATAGTGGC|AGCTCGAATGTGCAAGATAATCTTTACGGG
TCGTATCAATTACAGCTACCTCCTGCAGAT|GGTATGCCATAACGATTTCCCTCTATGGAC
CATTGGTGGTTGGACATGAATGTGATCGTT|CTAGAGACAACTGTGAAGCGAATGTAGAAT
CTGACGTCTACCATATTTCAACCGGGGAAT|TATTCGCCAAAAGGACACAGAGGGGTTACT
GCATCAACAACCGACTAGGGTATTCATAGA|GCGCAGCGACGAAACGCGATATTCGCAGCA
GCTTGTAAGCATAATCTAACATTGCATCTC|GACACTCGACTTATGATTTGCACGAGTGCT
AACAACCGACTAGGGTATTCATAGAGAACG|GCGACGAAACGCGATATTCGCAGCATTGCC
AATGACACTCGACTTATGATTTGCACGAGT|CACGAGTGCTAGAAGACTAGACGCCAGCTC
TAGCGAGAAGCAACCGAATGGTGTGAATGG|ACTTGAGTCGGGCTAAACCACCTACTCTCC
TACGGCGAATGTTGAATTGTTCGAGGGGGT|ATGATTTGCACGAGTGCTAGAACTCGACTT
GAATGCCATAGTTGGCCCCTGACGTCTACC|GCTCATAATCGGTTCGTGTATTCGCCAAAA
CACGAGTGCTAGACCCTGCAGATGTCGATC|TGTCCAACAGGTTGTGGTATCCTAGAGTGA
CTAGATACTCGACTTATGATTTGCACGAGT|GATCGTATCAATTACAGCTACCTCCTGCAG
CTGGGTGCGCCGGAGATGTCTCTAGGGCAT|CATAAGTTTCACGTACCATGATAAGGGCGC
CCTCTATGGACTTACACACTCGACTTATGA|GCTTAACTCGACTTATGATTTGCACGAGTG
CTAAATGACACTCGACTTATGATTTGCACG|TTGCACGAGTGCTAGAAGACTAGACGCCAG
TGATTTGCACGAGTGCTAGAAGAGAGGTGT|CATCAACAACCGACTAGGGTATTCATAGAG
CACGAACTCGACTTATGATTTGCACGAGTG|CATTGGTGGTTGGACATGAATGTGATCGTT
CTAGACCCTGCAGATGTCGATCACAGACCG|AGGTTGTGGTATCCTAGAGTGAGGGTGATA
CTCGACTTATGATTTGCACGAGTGCTAGAT|TTGCACGAGTGCTAGATGACACTATTCACG
TCGACTTATGATTTGCACGAGTGCTAGAGA|CAATTACAGCTACCTCCTGCAGATCGCGCT
GCGAATGTTGAATTGTTCGAGGGGGTGTGC|TTTGCACGAGTGCTAGAACTCGACTTATGA
TTAACTCGACTTATGATTTGCACGAGTGCT|AGTGGCTATTGCTGTCTATATGTCCAACAG
CGCCAGCTCGAATGTGCAAGATAATCTTTA|ATGATTTGCACGAGTGCTAGAACCCAATCA
ACGGCGAATGTTGAATTGTTCGAGGGGGTG|TGATTTGCACGAGTGCTAGAACTCGACTTA
TGGAAGGACTCGACTTATGATTTGCACGAG|AGGTTGACGCGAATGCCATAGTTGGCCCCT
GCCCTGCATTGGTGGTTGGACATGAATGTG|CGAGTGCTAGAGACAACTGTGAAGCGAATG
ATCTAACATTGCATCTCTTTACCAGTGGTT|TGATTTGCACGAGTGCTAGATATCAACGCT
GGTGCGCCGGAGATGTCTCTAGGGCATCAA|AAGTTTCACGTACCATGATAAGGGCGCAGC
TAGATGACACTATTCACGGTATGCCATAAC|GCATAATCTAACATTGCATCTCTTTACCAG
GGGAATCGCCATAAGTTTCACGTACCATGA|GTTACTAGACACTCAGAAACCTTCGAGGGG
TAGAGACAACTGTGAAGCGAATGTAGAATC|CGCGCTGAGTCCTTGTACGGCGAATGTTGA
AAGGGCTGGAAGGACTCGACTTATGATTTG|GATGTTAGGTTGACGCGAATGCCATAGTTG
TCGACTTATGATTTGCACGAGTGCTAGATG|TGCTAGACGAGTCTAAGCTTGTAAGCATAA
GCATAATCTAACATTGCATCTCTTTACCAG|ACTTATGATTTGCACGAGTGCTAGATATCA
TGCCATAGTTGGCCCCTGACGTCTACCATA|CATAATCGGTTCGTGTATTCGCCAAAAGGA
GACACTCGACTTATGATTTGCACGAGTGCT|GAGTGCTAGAAGACTAGACGCCAGCTCGAA
GTGGCTATTGCTGTCTATATGTCCAACAGG|ACGGGTCGGTGGCGCTCTATTAATAACGAC
TCGACTTATGATTTGCACGAGTGCTAGAAG|AGAGGTGTCCCTTGAAGGGCTGGAAGGACT
AGAACTCGACTTATGATTTGACTCGACTTA|TCTGCGCATCTAGGTCAGTTGCAAATAGGA
CCTGCAGATGTCGATCACAGACCGTCGCGA|TGGTATCCTAGAGTGAGGGTGATAACCATG
TGCTAGACCCTGCAGATGTCGATCACAGAC|ACAGGTTGTGGTATCCTAGAGTGAGGGTGA
GACTTATGATTTGCACGAGTGCTAGATCGT|CACGAGTGCTAGATGACACTATTCACGGTA
ATTTGACTCGACTTATGATTTGCACGAGTG|CAGTTGCAAATAGGACTCATGTTGGCACAG
AACAGGTTGTGGTATCCTAGAGTGAGGGTG|AACGACCAGACTCGACTTATGATTTGCACG
GTGGTTGGCTTAACTCGACTTATGATTTGC|AACGCTAATAGTGGCTATTGCTGTCTATAT
TGCTAGAGACAACTGTGAAGCGAATGTAGA|GATCGCGCTGAGTCCTTGTACGGCGAATGT
CGGGCTAAACCACCTACTCTCCCACTCGAC|AAGACCGACTAAAGTAAGGAACTCGACTTA
ACGAGTGCTAGACACGAACTCGACTTATGA|GGCACAGCCCTGCATTGGTGGTTGGACATG
TTGCACGAGTGCTAGACACGAACTCGACTT|TGTTGGCACAGCCCTGCATTGGTGGTTGGA
TTGCTAAATGACACTCGACTTATGATTTGC|GATTTGCACGAGTGCTAGAAGACTAGACGC
AATCTAACATTGCATCTCTTTACCAGTGGT|ATGATTTGCACGAGTGCTAGATATCAACGC
ACTTATGATTTGCACGAGTGCTAGAACTCG|CACGAGTGCTAGACCCTGCAGATGTCGATC
TCGAATGTGCAAGATAATCTTTACGGGTCG|GCACGAGTGCTAGAACCCAATCACTACGAG
GCTAGATGACACTATTCACGGTATGCCATA|AAGCATAATCTAACATTGCATCTCTTTACC
AAAGACCGACTAAAGTAAGGAACTCGACTT|TCACCCAGACTCGACTTATGATTTGCACGA
GGTTGACGCGAATGCCATAGTTGGCCCCTG|CTACCGTGAGCTCATAATCGGTTCGTGTAT
CTACCTCCTGCAGATCGCGCTGAGTCCTTG|TTTCCCTCTATGGACTTACACACTCGACTT
ACTCGACTTATGATTTGCACGAGTGCTAGA|CGCGAATGCCATAGTTGGCCCCTGACGTCT
GGGCTGGAAGGACTCGACTTATGATTTGCA|TGTTAGGTTGACGCGAATGCCATAGTTGGC
AATCAATAGTAGAAAGACCGACTAAAGTAA|GAGGGGGTGTGCTCACCCAGACTCGACTTA
ATGTCGATCACAGACCGTCGCGATACACCT|CTAGAGTGAGGGTGATAACCATGACTCGAC
ACCATATTTCAACCGGGGAATCGCCATAAG|AAAGGACACAGAGGGGTTACTAGACACTCA
ATCGCGCTGAGTCCTTGTACGGCGAATGTT|ACTTACACACTCGACTTATGATTTGCACGA
CTTATGATTTGCACGAGTGCTAGAGTGCTA|GGACATGAATGTGATCGTTTGGTGAAGTCG
GGATGTTAGGTTGACGCGAATGCCATAGTT|TATACATTCTACCGTGAGCTCATAATCGGT
AAGGACTCGACTTATGATTTGCACGAGTGC|TTGACGCGAATGCCATAGTTGGCCCCTGAC
GATTTGCACGAGTGCTAGAACTCGACTTAT|TGCTAGACCCTGCAGATGTCGATCACAGAC
AACGAGGATGTTAGGTTGACGCGAATGCCA|TGCCCTATACATTCTACCGTGAGCTCATAA
GACTTATGATTTGCACGAGTGCTAGACGAG|CACAGACCGTCGCGATACACCTGGTGTTGC
TAAGTTTCACGTACCATGATAAGGGCGCAG|CTCAGAAACCTTCGAGGGGGCTTCGCCCAG
CTCGACTTATGATTTGCACGAGTGCTAGAA|TTTGCACGAGTGCTAGACCCTGCAGATGTC
TCTAGGTCAGTTGCAAATAGGACTCATGTT|TTGCACGAGTGCTAGATACTCGACTTATGA
AGTGCTAGATATCAACGCTAATAGTGGCTA|CTCGAATGTGCAAGATAATCTTTACGGGTC
CTATTGCTGTCTATATGTCCAACAGGTTGT|GTCGGTGGCGCTCTATTAATAACGACCAGA
ATGATAAGGGCGCAGCGACGAAACGCGATA|GGGGGCTTCGCCCAGCCAGCTCGATGATTC
AACGATTTCCCTCTATGGACTTACACACTC|CAGTGGTTGGCTTAACTCGACTTATGATTT
TGCACGAGTGCTAGACCCTGCAGATGTCGA|TATGTCCAACAGGTTGTGGTATCCTAGAGT
TCGACTTATGATTTGCACGAGTGCTAGACG|ATCACAGACCGTCGCGATACACCTGGTGTT
CGGGTCGGTGGCGCTCTATTAATAACGACC|CTACGAGATTACACACTGGGTGCGCCGGAG
AGTGCTAGAGACAACTGTGAAGCGAATGTA|CAGATCGCGCTGAGTCCTTGTACGGCGAAT
GTGCTAGATAGCGAGAAGCAACCGAATGGT|AAGTCGTAACTTGAGTCGGGCTAAACCACC
CTTGTACGGCGAATGTTGAATTGTTCGAGG|ACTTATGATTTGCACGAGTGCTAGAACTCG
ATTTCCCTCTATGGACTTACACACTCGACT|GGTTGGCTTAACTCGACTTATGATTTGCAC
TTATGATTTGCACGAGTGCTAGAGACAACT|ACAGCTACCTCCTGCAGATCGCGCTGAGTC
AGGGTATTCATAGAGAACGAGGATGTTAGG|CGATATTCGCAGCATTGCCCTATACATTCT
TAGACCCTGCAGATGTCGATCACAGACCGT|GGTTGTGGTATCCTAGAGTGAGGGTGATAA
AGAAGACTAGACGCCAGCTCGAATGTGCAA|GGACTCGACTTATGATTTGCACGAGTGCTA
GTGGCGCTCTATTAATAACGACCAGACTCG|ATTACACACTGGGTGCGCCGGAGATGTCTC
ATAGTAGAAAGACCGACTAAAGTAAGGAAC|GGTGTGCTCACCCAGACTCGACTTATGATT
CCCTGCAGATGTCGATCACAGACCGTCGCG|GTGGTATCCTAGAGTGAGGGTGATAACCAT
GCTACCTCCTGCAGATCGCGCTGAGTCCTT|ATTTCCCTCTATGGACTTACACACTCGACT
GGGTATTCATAGAGAACGAGGATGTTAGGT|GATATTCGCAGCATTGCCCTATACATTCTA
GAGTGCTAGAGACAACTGTGAAGCGAATGT|GCAGATCGCGCTGAGTCCTTGTACGGCGAA
TAGATCGTATCAATTACAGCTACCTCCTGC|TCACGGTATGCCATAACGATTTCCCTCTAT
ACTCGACTTATGATTTGCACGAGTGCTAGA|ATTTGCACGAGTGCTAGACCCTGCAGATGT
CTCTATGGACTTACACACTCGACTTATGAT|CTTAACTCGACTTATGATTTGCACGAGTGC
CGAGTGCTAGAACTCGACTTATGATTTGAC|GACGCGTGTCTGCGCATCTAGGTCAGTTGC
GGGTCGGTGGCGCTCTATTAATAACGACCA|TACGAGATTACACACTGGGTGCGCCGGAGA
GATGTCTCTAGGGCATCAACAACCGACTAG|ACCATGATAAGGGCGCAGCGACGAAACGCG
GAGGTGTCCCTTGAAGGGCTGGAAGGACTC|CATAGAGAACGAGGATGTTAGGTTGACGCG
TGAAGTCGTAACTTGAGTCGGGCTAAACCA|AGATAAATCAATAGTAGAAAGACCGACTAA
CTCTATTAATAACGACCAGACTCGACTTAT|CACTGGGTGCGCCGGAGATGTCTCTAGGGC
AGATGTCGATCACAGACCGTCGCGATACAC|TCCTAGAGTGAGGGTGATAACCATGACTCG
GACTCGACTTATGATTTGCACGAGTGCTAG|GAGTGCTAGACGAGTCTAAGCTTGTAAGCA
TGCAAATAGGACTCATGTTGGCACAGCCCT|CTAGATACTCGACTTATGATTTGCACGAGT
GATCACAGACCGTCGCGATACACCTGGTGT|GTGAGGGTGATAACCATGACTCGACTTATG
CTCATGTTGGCACAGCCCTGCATTGGTGGT|ACTTATGATTTGCACGAGTGCTAGAGACAA
TGTGAAGCGAATGTAGAATCCAAGATAAAT|CCTTGTACGGCGAATGTTGAATTGTTCGAG
CTCGACTTATGATTTGCACGAGTGCTAGAA|TCTCTAGGGCATCAACAACCGACTAGGGTA
TCCCTCTATGGACTTACACACTCGACTTAT|TGGCTTAACTCGACTTATGATTTGCACGAG
TTCGAGGGGGTGTGCTCACCCAGACTCGAC|GAACTCGACTTATGATTTGCACGAGTGCTA
TGTCTATATGTCCAACAGGTTGTGGTATCC|GCGCTCTATTAATAACGACCAGACTCGACT
AAGACTAGACGCCAGCTCGAATGTGCAAGA|ACTCGACTTATGATTTGCACGAGTGCTAGA
TAGGTTGACGCGAATGCCATAGTTGGCCCC|TTCTACCGTGAGCTCATAATCGGTTCGTGT
GATACACCTGGTGTTGCTAAATGACACTCG|TGACTCGACTTATGATTTGCACGAGTGCTA
ACGAGTGCTAGAACCCAATCACTACGAGAT|CCCCTGACGTCTACCATATTTCAACCGGGG
TCTATGGACTTACACACTCGACTTATGATT|TTAACTCGACTTATGATTTGCACGAGTGCT
AGACGAGTCTAAGCTTGTAAGCATAATCTA|GTGTTGCTAAATGACACTCGACTTATGATT
ACTCGACTTATGATTTGCACGAGTGCTAGA|CGATCACAGACCGTCGCGATACACCTGGTG
CTCGACTTATGATTTGCACGAGTGCTAGAC|CAAATAGGACTCATGTTGGCACAGCCCTGC
GGCTTAACTCGACTTATGATTTGCACGAGT|AATAGTGGCTATTGCTGTCTATATGTCCAA
GACTTATGATTTGCACGAGTGCTAGAACCC|AATGCCATAGTTGGCCCCTGACGTCTACCA
TAAGCTTGTAAGCATAATCTAACATTGCAT|AATGACACTCGACTTATGATTTGCACGAGT
GACTAGGGTATTCATAGAGAACGAGGATGT|AACGCGATATTCGCAGCATTGCCCTATACA
CTGCGCATCTAGGTCAGTTGCAAATAGGAC|TTATGATTTGCACGAGTGCTAGATACTCGA
TAGTAGAAAGACCGACTAAAGTAAGGAACT|GTGTGCTCACCCAGACTCGACTTATGATTT
GAGGGGGTGTGCTCACCCAGACTCGACTTA|CTCGACTTATGATTTGCACGAGTGCTAGAC
GATTTCCCTCTATGGACTTACACACTCGAC|TGGTTGGCTTAACTCGACTTATGATTTGCA
ACGAGTGCTAGAAGACTAGACGCCAGCTCG|GGGCTGGAAGGACTCGACTTATGATTTGCA
CTCGACTTATGATTTGCACGAGTGCTAGAA|GCGAATGCCATAGTTGGCCCCTGACGTCTA
TGCACGAGTGCTAGAACTCGACTTATGATT|AATGGACGCGTGTCTGCGCATCTAGGTCAG
GCACGAGTGCTAGACACGAACTCGACTTAT|TTGGCACAGCCCTGCATTGGTGGTTGGACA
CGATACACCTGGTGTTGCTAAATGACACTC|ATGACTCGACTTATGATTTGCACGAGTGCT
GGACTCATGTTGGCACAGCCCTGCATTGGT|TCGACTTATGATTTGCACGAGTGCTAGAGA
ACCCTGCAGATGTCGATCACAGACCGTCGC|TGTGGTATCCTAGAGTGAGGGTGATAACCA
GTGAAGCGAATGTAGAATCCAAGATAAATC|CTTGTACGGCGAATGTTGAATTGTTCGAGG
GTCTAAGCTTGTAAGCATAATCTAACATTG|CTAAATGACACTCGACTTATGATTTGCACG
ACATTGCATCTCTTTACCAGTGGTTGGCTT|TGCACGAGTGCTAGATATCAACGCTAATAG
GGTGGTTGGACATGAATGTGATCGTTTGGT|AGACAACTGTGAAGCGAATGTAGAATCCAA
TCTAAGCTTGTAAGCATAATCTAACATTGC|TAAATGACACTCGACTTATGATTTGCACGA
CGGTATGCCATAACGATTTCCCTCTATGGA|CATCTCTTTACCAGTGGTTGGCTTAACTCG
ACACTCGACTTATGATTTGCACGAGTGCTA|TGATTTGCACGAGTGCTAGACCCTGCAGAT
TTATGATTTGCACGAGTGCTAGAGTGCTAG|GACATGAATGTGATCGTTTGGTGAAGTCGT
ACGAGTCTAAGCTTGTAAGCATAATCTAAC|GTTGCTAAATGACACTCGACTTATGATTTG
TCTGCGCATCTAGGTCAGTTGCAAATAGGA|CTTATGATTTGCACGAGTGCTAGATACTCG
GCTAGACGAGTCTAAGCTTGTAAGCATAAT|CTGGTGTTGCTAAATGACACTCGACTTATG
AAACCACCTACTCTCCCACTCGACTTATGA|GACTAAAGTAAGGAACTCGACTTATGATTT
TATGATTTGCACGAGTGCTAGACACGAACT|GACTCATGTTGGCACAGCCCTGCATTGGTG
AGAAGAGAGGTGTCCCTTGAAGGGCTGGAA|GGTATTCATAGAGAACGAGGATGTTAGGTT
AGGATGTTAGGTTGACGCGAATGCCATAGT|CTATACATTCTACCGTGAGCTCATAATCGG
GCCATAAGTTTCACGTACCATGATAAGGGC|GACACTCAGAAACCTTCGAGGGGGCTTCGC
TCGGTGGCGCTCTATTAATAACGACCAGAC|GAGATTACACACTGGGTGCGCCGGAGATGT
ATGATTTGCACGAGTGCTAGAAGAGAGGTG|GCATCAACAACCGACTAGGGTATTCATAGA
GGCGAATGTTGAATTGTTCGAGGGGGTGTG|ATTTGCACGAGTGCTAGAACTCGACTTATG
TTTGCACGAGTGCTAGAGACAACTGTGAAG|ACCTCCTGCAGATCGCGCTGAGTCCTTGTA
CGAGTGCTAGATGACACTATTCACGGTATG|CTTGTAAGCATAATCTAACATTGCATCTCT
TGACTCGACTTATGATTTGCACGAGTGCTA|GAAGAGAGGTGTCCCTTGAAGGGCTGGAAG
GACTTATGATTTGCACGAGTGCTAGAGACA|ATTACAGCTACCTCCTGCAGATCGCGCTGA
ATTTGCACGAGTGCTAGAGACAACTGTGAA|TACCTCCTGCAGATCGCGCTGAGTCCTTGT
TAGACGAGTCTAAGCTTGTAAGCATAATCT|GGTGTTGCTAAATGACACTCGACTTATGAT
ACTACGAGATTACACACTGGGTGCGCCGGA|TCAACCGGGGAATCGCCATAAGTTTCACGT
AGAAGCAACCGAATGGTGTGAATGGACGCG|AGTCGGGCTAAACCACCTACTCTCCCACTC
ACGAACTCGACTTATGATTTGCACGAGTGC|ATTGGTGGTTGGACATGAATGTGATCGTTT
ATCTCTTTACCAGTGGTTGGCTTAACTCGA|GTGCTAGATATCAACGCTAATAGTGGCTAT
TGCTAGAGTGCTAGATAGCGAGAAGCAACC|TTTGGTGAAGTCGTAACTTGAGTCGGGCTA
GACACTATTCACGGTATGCCATAACGATTT|ATCTAACATTGCATCTCTTTACCAGTGGTT
GTGCTAGAAGAGAGGTGTCCCTTGAAGGGC|ACTAGGGTATTCATAGAGAACGAGGATGTT
ATGGACGCGTGTCTGCGCATCTAGGTCAGT|CTCCCACTCGACTTATGATTTGCACGAGTG
GATCGTATCAATTACAGCTACCTCCTGCAG|ACGGTATGCCATAACGATTTCCCTCTATGG
GAAGCAACCGAATGGTGTGAATGGACGCGT|GTCGGGCTAAACCACCTACTCTCCCACTCG
TAAATCAATAGTAGAAAGACCGACTAAAGT|TCGAGGGGGTGTGCTCACCCAGACTCGACT
GTTAGGTTGACGCGAATGCCATAGTTGGCC|CATTCTACCGTGAGCTCATAATCGGTTCGT
AGTCGGGCTAAACCACCTACTCTCCCACTC|AGAAAGACCGACTAAAGTAAGGAACTCGAC
CCACCTACTCTCCCACTCGACTTATGATTT|TAAAGTAAGGAACTCGACTTATGATTTGCA
ATCACTACGAGATTACACACTGGGTGCGCC|ATTTCAACCGGGGAATCGCCATAAGTTTCA
CAGACTCGACTTATGATTTGCACGAGTGCT|ACGAGTGCTAGACGAGTCTAAGCTTGTAAG
CTCTCCCACTCGACTTATGATTTGCACGAG|AGGAACTCGACTTATGATTTGCACGAGTGC
ACGAGTGCTAGATATCAACGCTAATAGTGG|CAGCTCGAATGTGCAAGATAATCTTTACGG
GTCCCTTGAAGGGCTGGAAGGACTCGACTT|AGAACGAGGATGTTAGGTTGACGCGAATGC
CCAGACTCGACTTATGATTTGCACGAGTGC|AGATGTCTCTAGGGCATCAACAACCGACTA
CTTATGATTTGACTCGACTTATGATTTGCA|CTAGGTCAGTTGCAAATAGGACTCATGTTG
AGTGCTAGAGTGCTAGATAGCGAGAAGCAA|CGTTTGGTGAAGTCGTAACTTGAGTCGGGC
TGACACTATTCACGGTATGCCATAACGATT|AATCTAACATTGCATCTCTTTACCAGTGGT
GAACTCGACTTATGATTTGCACGAGTGCTA|GATTTGCACGAGTGCTAGATGACACTATTC
GCACGAGTGCTAGATACTCGACTTATGATT|CGAGTGCTAGATCGTATCAATTACAGCTAC
ATTAATAACGACCAGACTCGACTTATGATT|GGGTGCGCCGGAGATGTCTCTAGGGCATCA
TGGTATCCTAGAGTGAGGGTGATAACCATG|ACTCGACTTATGATTTGCACGAGTGCTAGA
ACTATTCACGGTATGCCATAACGATTTCCC|TAACATTGCATCTCTTTACCAGTGGTTGGC
TCCAAGATAAATCAATAGTAGAAAGACCGA|GAATTGTTCGAGGGGGTGTGCTCACCCAGA
AATCCAAGATAAATCAATAGTAGAAAGACC|TTGAATTGTTCGAGGGGGTGTGCTCACCCA
TATTCATAGAGAACGAGGATGTTAGGTTGA|ATTCGCAGCATTGCCCTATACATTCTACCG
AACATTGCATCTCTTTACCAGTGGTTGGCT|TTGCACGAGTGCTAGATATCAACGCTAATA
GCGTGTCTGCGCATCTAGGTCAGTTGCAAA|CTCGACTTATGATTTGCACGAGTGCTAGAT
CGTCTACCATATTTCAACCGGGGAATCGCC|CGCCAAAAGGACACAGAGGGGTTACTAGAC
CGAGATTACACACTGGGTGCGCCGGAGATG|CCGGGGAATCGCCATAAGTTTCACGTACCA
ATTACAGCTACCTCCTGCAGATCGCGCTGA|ATAACGATTTCCCTCTATGGACTTACACAC
GTAACTTGAGTCGGGCTAAACCACCTACTC|TCAATAGTAGAAAGACCGACTAAAGTAAGG
GAAGACTAGACGCCAGCTCGAATGTGCAAG|GACTCGACTTATGATTTGCACGAGTGCTAG
AACCATGACTCGACTTATGATTTGCACGAG|TGCTAGAAGAGAGGTGTCCCTTGAAGGGCT
CCCTGACGTCTACCATATTTCAACCGGGGA|TGTATTCGCCAAAAGGACACAGAGGGGTTA
GATTTGCACGAGTGCTAGACGAGTCTAAGC|CGTCGCGATACACCTGGTGTTGCTAAATGA
GAGACAACTGTGAAGCGAATGTAGAATCCA|CGCTGAGTCCTTGTACGGCGAATGTTGAAT
GTTCGAGGGGGTGTGCTCACCCAGACTCGA|AGAACTCGACTTATGATTTGCACGAGTGCT
TAGTGGCTATTGCTGTCTATATGTCCAACA|TTACGGGTCGGTGGCGCTCTATTAATAACG
TGTTAGGTTGACGCGAATGCCATAGTTGGC|ACATTCTACCGTGAGCTCATAATCGGTTCG
ATCAATAGTAGAAAGACCGACTAAAGTAAG|AGGGGGTGTGCTCACCCAGACTCGACTTAT
CTTATGATTTGCACGAGTGCTAGACACGAA|AGGACTCATGTTGGCACAGCCCTGCATTGG
GCGCATCTAGGTCAGTTGCAAATAGGACTC|ATGATTTGCACGAGTGCTAGATACTCGACT
GCGCCGGAGATGTCTCTAGGGCATCAACAA|TTTCACGTACCATGATAAGGGCGCAGCGAC
TGCACGAGTGCTAGACACGAACTCGACTTA|GTTGGCACAGCCCTGCATTGGTGGTTGGAC
GCCATAACGATTTCCCTCTATGGACTTACA|TTTACCAGTGGTTGGCTTAACTCGACTTAT
TCCAACAGGTTGTGGTATCCTAGAGTGAGG|AATAACGACCAGACTCGACTTATGATTTGC
GAATGTAGAATCCAAGATAAATCAATAGTA|GGCGAATGTTGAATTGTTCGAGGGGGTGTG
TGTCCAACAGGTTGTGGTATCCTAGAGTGA|TTAATAACGACCAGACTCGACTTATGATTT
ACGAGTGCTAGATACTCGACTTATGATTTG|AGTGCTAGATCGTATCAATTACAGCTACCT
CACGGTATGCCATAACGATTTCCCTCTATG|TGCATCTCTTTACCAGTGGTTGGCTTAACT
GTACCATGATAAGGGCGCAGCGACGAAACG|TTCGAGGGGGCTTCGCCCAGCCAGCTCGAT
AGTTTCACGTACCATGATAAGGGCGCAGCG|CAGAAACCTTCGAGGGGGCTTCGCCCAGCC
TATGATTTGCACGAGTGCTAGACGAGTCTA|GACCGTCGCGATACACCTGGTGTTGCTAAA
TATGCCATAACGATTTCCCTCTATGGACTT|CTCTTTACCAGTGGTTGGCTTAACTCGACT
ATATCAACGCTAATAGTGGCTATTGCTGTC|TGCAAGATAATCTTTACGGGTCGGTGGCGC
GGCTGGAAGGACTCGACTTATGATTTGCAC|GTTAGGTTGACGCGAATGCCATAGTTGGCC
CGAGTGCTAGACGAGTCTAAGCTTGTAAGC|TACACCTGGTGTTGCTAAATGACACTCGAC
ATGATTTGCACGAGTGCTAGACACGAACTC|ACTCATGTTGGCACAGCCCTGCATTGGTGG
TCTCTTTACCAGTGGTTGGCTTAACTCGAC|TGCTAGATATCAACGCTAATAGTGGCTATT
GTCCTTGTACGGCGAATGTTGAATTGTTCG|TCGACTTATGATTTGCACGAGTGCTAGAAC
ATGATTTGCACGAGTGCTAGAGTGCTAGAT|CATGAATGTGATCGTTTGGTGAAGTCGTAA
CGACCAGACTCGACTTATGATTTGCACGAG|CGGAGATGTCTCTAGGGCATCAACAACCGA
CTAGAGTGCTAGATAGCGAGAAGCAACCGA|TGGTGAAGTCGTAACTTGAGTCGGGCTAAA
GCGATACACCTGGTGTTGCTAAATGACACT|CATGACTCGACTTATGATTTGCACGAGTGC
GCTGGAAGGACTCGACTTATGATTTGCACG|TTAGGTTGACGCGAATGCCATAGTTGGCCC
CTGGTGTTGCTAAATGACACTCGACTTATG|ACTTATGATTTGCACGAGTGCTAGAAGACT
GCTAGACCCTGCAGATGTCGATCACAGACC|CAGGTTGTGGTATCCTAGAGTGAGGGTGAT
CTTATGATTTGCACGAGTGCTAGAACTCGA|ACGAGTGCTAGACCCTGCAGATGTCGATCA
GACTTATGATTTGCACGAGTGCTAGAAGAC|AGGTGTCCCTTGAAGGGCTGGAAGGACTCG
CACGAGTGCTAGACACGAACTCGACTTATG|TGGCACAGCCCTGCATTGGTGGTTGGACAT
TGGCCCCTGACGTCTACCATATTTCAACCG|TTCGTGTATTCGCCAAAAGGACACAGAGGG
GTCTATATGTCCAACAGGTTGTGGTATCCT|CGCTCTATTAATAACGACCAGACTCGACTT
CTCGACTTATGATTTGACTCGACTTATGAT|CGCATCTAGGTCAGTTGCAAATAGGACTCA
TGATTTGCACGAGTGCTAGAACCCAATCAC|ATAGTTGGCCCCTGACGTCTACCATATTTC
ATCCAAGATAAATCAATAGTAGAAAGACCG|TGAATTGTTCGAGGGGGTGTGCTCACCCAG
ATTTGCACGAGTGCTAGATATCAACGCTAA|AGACGCCAGCTCGAATGTGCAAGATAATCT
TCCTAGAGTGAGGGTGATAACCATGACTCG|ACTTATGATTTGCACGAGTGCTAGAAGAGA
CTTAACTCGACTTATGATTTGCACGAGTGC|TAGTGGCTATTGCTGTCTATATGTCCAACA
TCAATAGTAGAAAGACCGACTAAAGTAAGG|GGGGGTGTGCTCACCCAGACTCGACTTATG
GTGCTAGAAGACTAGACGCCAGCTCGAATG|TGGAAGGACTCGACTTATGATTTGCACGAG
GAGTGAGGGTGATAACCATGACTCGACTTA|TGATTTGCACGAGTGCTAGAAGAGAGGTGT
CTATTCACGGTATGCCATAACGATTTCCCT|AACATTGCATCTCTTTACCAGTGGTTGGCT
CACGAGTGCTAGAAGAGAGGTGTCCCTTGA|AACCGACTAGGGTATTCATAGAGAACGAGG
TTCATAGAGAACGAGGATGTTAGGTTGACG|TCGCAGCATTGCCCTATACATTCTACCGTG
TACCATATTTCAACCGGGGAATCGCCATAA|AAAAGGACACAGAGGGGTTACTAGACACTC
TAATCTTTACGGGTCGGTGGCGCTCTATTA|ACCCAATCACTACGAGATTACACACTGGGT
ATTTGCACGAGTGCTAGAACTCGACTTATG|GCTAGACCCTGCAGATGTCGATCACAGACC
ACTTATGATTTGACTCGACTTATGATTTGC|TCTAGGTCAGTTGCAAATAGGACTCATGTT
CGAGTGCTAGATCGTATCAATTACAGCTAC|ACACTATTCACGGTATGCCATAACGATTTC
CTCGACTTATGATTTGCACGAGTGCTAGAA|AACCGAATGGTGTGAATGGACGCGTGTCTG
TTGTAAGCATAATCTAACATTGCATCTCTT|CACTCGACTTATGATTTGCACGAGTGCTAG
CAACAACCGACTAGGGTATTCATAGAGAAC|AGCGACGAAACGCGATATTCGCAGCATTGC
CTTATGATTTGCACGAGTGCTAGATGACAC|AGACGAGTCTAAGCTTGTAAGCATAATCTA
CGCTAATAGTGGCTATTGCTGTCTATATGT|TAATCTTTACGGGTCGGTGGCGCTCTATTA
TGGTTGGACATGAATGTGATCGTTTGGTGA|ACAACTGTGAAGCGAATGTAGAATCCAAGA
GTTGCAAATAGGACTCATGTTGGCACAGCC|TGCTAGATACTCGACTTATGATTTGCACGA
AGACAACTGTGAAGCGAATGTAGAATCCAA|GCTGAGTCCTTGTACGGCGAATGTTGAATT
AGTGGCTATTGCTGTCTATATGTCCAACAG|TACGGGTCGGTGGCGCTCTATTAATAACGA
TAACTCGACTTATGATTTGCACGAGTGCTA|GTGGCTATTGCTGTCTATATGTCCAACAGG
ATGATTTGCACGAGTGCTAGAACTCGACTT|AGTGCTAGACCCTGCAGATGTCGATCACAG
GATAATCTTTACGGGTCGGTGGCGCTCTAT|GAACCCAATCACTACGAGATTACACACTGG
CGCCATAAGTTTCACGTACCATGATAAGGG|AGACACTCAGAAACCTTCGAGGGGGCTTCG
ATCAACGCTAATAGTGGCTATTGCTGTCTA|CAAGATAATCTTTACGGGTCGGTGGCGCTC
TGTTGGCACAGCCCTGCATTGGTGGTTGGA|ATGATTTGCACGAGTGCTAGAGACAACTGT
GCTTAACTCGACTTATGATTTGCACGAGTG|ATAGTGGCTATTGCTGTCTATATGTCCAAC
TGTGCTCACCCAGACTCGACTTATGATTTG|TATGATTTGCACGAGTGCTAGACGAGTCTA
TTTACCAGTGGTTGGCTTAACTCGACTTAT|AGATATCAACGCTAATAGTGGCTATTGCTG
CGGGGAATCGCCATAAGTTTCACGTACCAT|GGGTTACTAGACACTCAGAAACCTTCGAGG
CTTATGATTTGCACGAGTGCTAGAAGAGAG|AGGGCATCAACAACCGACTAGGGTATTCAT
CGACTTATGATTTGCACGAGTGCTAGAACT|TGCACGAGTGCTAGACCCTGCAGATGTCGA
GGGTGCGCCGGAGATGTCTCTAGGGCATCA|TAAGTTTCACGTACCATGATAAGGGCGCAG
ATGCCATAGTTGGCCCCTGACGTCTACCAT|TCATAATCGGTTCGTGTATTCGCCAAAAGG
ACTCGACTTATGATTTGCACGAGTGCTAGA|CGACTTATGATTTGCACGAGTGCTAGATCG
TGCACGAGTGCTAGAGACAACTGTGAAGCG|CTCCTGCAGATCGCGCTGAGTCCTTGTACG
TTGACTCGACTTATGATTTGCACGAGTGCT|GTTGCAAATAGGACTCATGTTGGCACAGCC
CCTAGAGTGAGGGTGATAACCATGACTCGA|CTTATGATTTGCACGAGTGCTAGAAGAGAG
GAGTGCTAGAACTCGACTTATGATTTGCAC|CTGCAGATGTCGATCACAGACCGTCGCGAT
CAGTTGCAAATAGGACTCATGTTGGCACAG|AGTGCTAGATACTCGACTTATGATTTGCAC
ATACACCTGGTGTTGCTAAATGACACTCGA|GACTCGACTTATGATTTGCACGAGTGCTAG
GACCAGACTCGACTTATGATTTGCACGAGT|GGAGATGTCTCTAGGGCATCAACAACCGAC
GCCCCTGACGTCTACCATATTTCAACCGGG|CGTGTATTCGCCAAAAGGACACAGAGGGGT
TCGACTTATGATTTGCACGAGTGCTAGACC|CTATTGCTGTCTATATGTCCAACAGGTTGT
TGTCTGCGCATCTAGGTCAGTTGCAAATAG|GACTTATGATTTGCACGAGTGCTAGATACT
TAACCATGACTCGACTTATGATTTGCACGA|GTGCTAGAAGAGAGGTGTCCCTTGAAGGGC
TATGTCCAACAGGTTGTGGTATCCTAGAGT|TATTAATAACGACCAGACTCGACTTATGAT
TACACCTGGTGTTGCTAAATGACACTCGAC|ACTCGACTTATGATTTGCACGAGTGCTAGA
GATGTTAGGTTGACGCGAATGCCATAGTTG|ATACATTCTACCGTGAGCTCATAATCGGTT
GTCGTAACTTGAGTCGGGCTAAACCACCTA|AAATCAATAGTAGAAAGACCGACTAAAGTA
ATAAGTTTCACGTACCATGATAAGGGCGCA|ACTCAGAAACCTTCGAGGGGGCTTCGCCCA
TATTCACGGTATGCCATAACGATTTCCCTC|ACATTGCATCTCTTTACCAGTGGTTGGCTT
TGATTTGCACGAGTGCTAGAGACAACTGTG|GCTACCTCCTGCAGATCGCGCTGAGTCCTT
TATGATTTGCACGAGTGCTAGAACTCGACT|GAGTGCTAGACCCTGCAGATGTCGATCACA
AGACACGAACTCGACTTATGATTTGCACGA|CTGCATTGGTGGTTGGACATGAATGTGATC
AAGACCGACTAAAGTAAGGAACTCGACTTA|CACCCAGACTCGACTTATGATTTGCACGAG
CCAACAGGTTGTGGTATCCTAGAGTGAGGG|ATAACGACCAGACTCGACTTATGATTTGCA
AACTCGACTTATGATTTGCACGAGTGCTAG|ATTTGCACGAGTGCTAGATGACACTATTCA
ACTAGGGTATTCATAGAGAACGAGGATGTT|ACGCGATATTCGCAGCATTGCCCTATACAT
AAGGAACTCGACTTATGATTTGCACGAGTG|TATGATTTGCACGAGTGCTAGATGACACTA
ACTTATGATTTGCACGAGTGCTAGAAGAGA|TAGGGCATCAACAACCGACTAGGGTATTCA
AAGCATAATCTAACATTGCATCTCTTTACC|CGACTTATGATTTGCACGAGTGCTAGATAT
TCCTTGTACGGCGAATGTTGAATTGTTCGA|CGACTTATGATTTGCACGAGTGCTAGAACT
CTAGACGAGTCTAAGCTTGTAAGCATAATC|TGGTGTTGCTAAATGACACTCGACTTATGA
ATGAATGTGATCGTTTGGTGAAGTCGTAAC|AAGCGAATGTAGAATCCAAGATAAATCAAT
TAACGACCAGACTCGACTTATGATTTGCAC|CGCCGGAGATGTCTCTAGGGCATCAACAAC
TTATGATTTGCACGAGTGCTAGAACTCGAC|CGAGTGCTAGACCCTGCAGATGTCGATCAC
TCTATATGTCCAACAGGTTGTGGTATCCTA|GCTCTATTAATAACGACCAGACTCGACTTA
AGATAGCGAGAAGCAACCGAATGGTGTGAA|GTAACTTGAGTCGGGCTAAACCACCTACTC
AGCTACCTCCTGCAGATCGCGCTGAGTCCT|GATTTCCCTCTATGGACTTACACACTCGAC
GTCGATCACAGACCGTCGCGATACACCTGG|AGAGTGAGGGTGATAACCATGACTCGACTT
CAGTGGTTGGCTTAACTCGACTTATGATTT|TCAACGCTAATAGTGGCTATTGCTGTCTAT
TGTCGATCACAGACCGTCGCGATACACCTG|TAGAGTGAGGGTGATAACCATGACTCGACT
CACGAGTGCTAGAACCCAATCACTACGAGA|GCCCCTGACGTCTACCATATTTCAACCGGG
GAGTCCTTGTACGGCGAATGTTGAATTGTT|ACTCGACTTATGATTTGCACGAGTGCTAGA
AGAGAGGTGTCCCTTGAAGGGCTGGAAGGA|ATTCATAGAGAACGAGGATGTTAGGTTGAC
CACTACGAGATTACACACTGGGTGCGCCGG|TTCAACCGGGGAATCGCCATAAGTTTCACG
TAAATGACACTCGACTTATGATTTGCACGA|TGCACGAGTGCTAGAAGACTAGACGCCAGC
TGCATTGGTGGTTGGACATGAATGTGATCG|TGCTAGAGACAACTGTGAAGCGAATGTAGA
TTGCACGAGTGCTAGATCGTATCAATTACA|AGATGACACTATTCACGGTATGCCATAACG
CGACTTATGATTTGCACGAGTGCTAGAAGA|GAGGTGTCCCTTGAAGGGCTGGAAGGACTC
ACTTATGATTTGCACGAGTGCTAGATGACA|TAGACGAGTCTAAGCTTGTAAGCATAATCT
TCTAACATTGCATCTCTTTACCAGTGGTTG|GATTTGCACGAGTGCTAGATATCAACGCTA
TGAGTCCTTGTACGGCGAATGTTGAATTGT|CACTCGACTTATGATTTGCACGAGTGCTAG
CCAATCACTACGAGATTACACACTGGGTGC|CATATTTCAACCGGGGAATCGCCATAAGTT
AGCATAATCTAACATTGCATCTCTTTACCA|GACTTATGATTTGCACGAGTGCTAGATATC
GTGCTAGACACGAACTCGACTTATGATTTG|CAGCCCTGCATTGGTGGTTGGACATGAATG
CGAATGTAGAATCCAAGATAAATCAATAGT|CGGCGAATGTTGAATTGTTCGAGGGGGTGT
CGAGAAGCAACCGAATGGTGTGAATGGACG|TGAGTCGGGCTAAACCACCTACTCTCCCAC
TGCAAGATAATCTTTACGGGTCGGTGGCGC|TGCTAGAACCCAATCACTACGAGATTACAC
ATTTGCACGAGTGCTAGACACGAACTCGAC|CATGTTGGCACAGCCCTGCATTGGTGGTTG
TATCAATTACAGCTACCTCCTGCAGATCGC|ATGCCATAACGATTTCCCTCTATGGACTTA
AACTTGAGTCGGGCTAAACCACCTACTCTC|AATAGTAGAAAGACCGACTAAAGTAAGGAA
GATTTGCACGAGTGCTAGAGACAACTGTGA|CTACCTCCTGCAGATCGCGCTGAGTCCTTG
CATAATCTAACATTGCATCTCTTTACCAGT|CTTATGATTTGCACGAGTGCTAGATATCAA
AAAAACTCGACTTATGATTTGCACGAGTGC|GAAGCAACCGAATGGTGTGAATGGACGCGT
CGACTTATGATTTGCACGAGTGCTAGAAGA|TCTAGGGCATCAACAACCGACTAGGGTATT
CTCACCCAGACTCGACTTATGATTTGCACG|ATTTGCACGAGTGCTAGACGAGTCTAAGCT
TATGATTTGCACGAGTGCTAGATCGTATCA|AGTGCTAGATGACACTATTCACGGTATGCC
TGGGTGCGCCGGAGATGTCTCTAGGGCATC|ATAAGTTTCACGTACCATGATAAGGGCGCA
AATAGTAGAAAGACCGACTAAAGTAAGGAA|GGGTGTGCTCACCCAGACTCGACTTATGAT
TGATAAGGGCGCAGCGACGAAACGCGATAT|GGGGCTTCGCCCAGCCAGCTCGATGATTCA
CTTATGATTTGCACGAGTGCTAGATATCAA|AAGACTAGACGCCAGCTCGAATGTGCAAGA
ACGCCAGCTCGAATGTGCAAGATAATCTTT|TATGATTTGCACGAGTGCTAGAACCCAATC
GTATTCATAGAGAACGAGGATGTTAGGTTG|TATTCGCAGCATTGCCCTATACATTCTACC
AGACCCTGCAGATGTCGATCACAGACCGTC|GTTGTGGTATCCTAGAGTGAGGGTGATAAC
TTGCACGAGTGCTAGAGACAACTGTGAAGC|CCTCCTGCAGATCGCGCTGAGTCCTTGTAC
GCAGCGACGAAACGCGATATTCGCAGCATT|CCAGCCAGCTCGATGATTCAACGTAGAGCA
ACCGTCGCGATACACCTGGTGTTGCTAAAT|GATAACCATGACTCGACTTATGATTTGCAC
AGAATCCAAGATAAATCAATAGTAGAAAGA|TGTTGAATTGTTCGAGGGGGTGTGCTCACC
TAATAGTGGCTATTGCTGTCTATATGTCCA|TCTTTACGGGTCGGTGGCGCTCTATTAATA
TCATGTTGGCACAGCCCTGCATTGGTGGTT|CTTATGATTTGCACGAGTGCTAGAGACAAC
AGACGCCAGCTCGAATGTGCAAGATAATCT|CTTATGATTTGCACGAGTGCTAGAACCCAA
TTCCCTCTATGGACTTACACACTCGACTTA|TTGGCTTAACTCGACTTATGATTTGCACGA
CAGACCGTCGCGATACACCTGGTGTTGCTA|GGTGATAACCATGACTCGACTTATGATTTG
CACGAGTGCTAGAACTCGACTTATGATTTG|TGGACGCGTGTCTGCGCATCTAGGTCAGTT
TTGCACGAGTGCTAGATATCAACGCTAATA|ACGCCAGCTCGAATGTGCAAGATAATCTTT
CTACCATATTTCAACCGGGGAATCGCCATA|CAAAAGGACACAGAGGGGTTACTAGACACT
TGATTTGCACGAGTGCTAGATATCAACGCT|CTAGACGCCAGCTCGAATGTGCAAGATAAT
TTAGGTTGACGCGAATGCCATAGTTGGCCC|ATTCTACCGTGAGCTCATAATCGGTTCGTG
CTCGACTTATGATTTGCACGAGTGCTAGAT|GCTAGAAGACTAGACGCCAGCTCGAATGTG
TTATGATTTGCACGAGTGCTAGATGACACT|GACGAGTCTAAGCTTGTAAGCATAATCTAA
ACGAGTGCTAGAGACAACTGTGAAGCGAAT|CTGCAGATCGCGCTGAGTCCTTGTACGGCG
TTCACGTACCATGATAAGGGCGCAGCGACG|AAACCTTCGAGGGGGCTTCGCCCAGCCAGC
GTGCGCCGGAGATGTCTCTAGGGCATCAAC|AGTTTCACGTACCATGATAAGGGCGCAGCG
CAATCACTACGAGATTACACACTGGGTGCG|ATATTTCAACCGGGGAATCGCCATAAGTTT
CTTATGATTTGCACGAGTGCTAGATCGTAT|CGAGTGCTAGATGACACTATTCACGGTATG
AGATAAATCAATAGTAGAAAGACCGACTAA|TGTTCGAGGGGGTGTGCTCACCCAGACTCG
ATAACCATGACTCGACTTATGATTTGCACG|AGTGCTAGAAGAGAGGTGTCCCTTGAAGGG
AACTGTGAAGCGAATGTAGAATCCAAGATA|AGTCCTTGTACGGCGAATGTTGAATTGTTC
GATTTGCACGAGTGCTAGATACTCGACTTA|TTGCACGAGTGCTAGATCGTATCAATTACA
ACGCTAATAGTGGCTATTGCTGTCTATATG|ATAATCTTTACGGGTCGGTGGCGCTCTATT
CCTTGAAGGGCTGGAAGGACTCGACTTATG|ACGAGGATGTTAGGTTGACGCGAATGCCAT
TTTACGGGTCGGTGGCGCTCTATTAATAAC|ATCACTACGAGATTACACACTGGGTGCGCC
GACACGAACTCGACTTATGATTTGCACGAG|TGCATTGGTGGTTGGACATGAATGTGATCG
GGCATCAACAACCGACTAGGGTATTCATAG|GGCGCAGCGACGAAACGCGATATTCGCAGC
GACTTATGATTTGCACGAGTGCTAGACACG|ATAGGACTCATGTTGGCACAGCCCTGCATT
TTGAAGGGCTGGAAGGACTCGACTTATGAT|GAGGATGTTAGGTTGACGCGAATGCCATAG
GCTAATAGTGGCTATTGCTGTCTATATGTC|AATCTTTACGGGTCGGTGGCGCTCTATTAA
TCGACTTATGATTTGCACGAGTGCTAGATC|TGCACGAGTGCTAGATGACACTATTCACGG
ACTTGAGTCGGGCTAAACCACCTACTCTCC|ATAGTAGAAAGACCGACTAAAGTAAGGAAC
AATCTTTACGGGTCGGTGGCGCTCTATTAA|CCCAATCACTACGAGATTACACACTGGGTG
TAGGGTATTCATAGAGAACGAGGATGTTAG|GCGATATTCGCAGCATTGCCCTATACATTC
ATCTAGGTCAGTTGCAAATAGGACTCATGT|TTTGCACGAGTGCTAGATACTCGACTTATG
TTTCCCTCTATGGACTTACACACTCGACTT|GTTGGCTTAACTCGACTTATGATTTGCACG
ACGAGTGCTAGATGACACTATTCACGGTAT|GCTTGTAAGCATAATCTAACATTGCATCTC
CGAGTGCTAGAACCCAATCACTACGAGATT|CCCTGACGTCTACCATATTTCAACCGGGGA
AGAACGAGGATGTTAGGTTGACGCGAATGC|ATTGCCCTATACATTCTACCGTGAGCTCAT
CTCGACTTATGATTTGCACGAGTGCTAGAT|GTGCTAGACGAGTCTAAGCTTGTAAGCATA
CGACTTATGATTTGCACGAGTGCTAGATAC|CTTATGATTTGCACGAGTGCTAGATCGTAT
TGACACTCGACTTATGATTTGCACGAGTGC|CGAGTGCTAGAAGACTAGACGCCAGCTCGA
GACTAAAGTAAGGAACTCGACTTATGATTT|GACTCGACTTATGATTTGCACGAGTGCTAG
TATGATTTGCACGAGTGCTAGATGACACTA|ACGAGTCTAAGCTTGTAAGCATAATCTAAC
TCACAGACCGTCGCGATACACCTGGTGTTG|GAGGGTGATAACCATGACTCGACTTATGAT
CACGAGTGCTAGAACTCGACTTATGATTTG|ACCCTGCAGATGTCGATCACAGACCGTCGC
GACTAGACGCCAGCTCGAATGTGCAAGATA|TCGACTTATGATTTGCACGAGTGCTAGAAC
ACTTATGATTTGCACGAGTGCTAGATCGTA|ACGAGTGCTAGATGACACTATTCACGGTAT
AGCAACCGAATGGTGTGAATGGACGCGTGT|CGGGCTAAACCACCTACTCTCCCACTCGAC
AAGCGAATGTAGAATCCAAGATAAATCAAT|GTACGGCGAATGTTGAATTGTTCGAGGGGG
GATTTGCACGAGTGCTAGAACCCAATCACT|TAGTTGGCCCCTGACGTCTACCATATTTCA
TAACTTGAGTCGGGCTAAACCACCTACTCT|CAATAGTAGAAAGACCGACTAAAGTAAGGA
TCTAGGGCATCAACAACCGACTAGGGTATT|ATAAGGGCGCAGCGACGAAACGCGATATTC
CCGGGGAATCGCCATAAGTTTCACGTACCA|GGGGTTACTAGACACTCAGAAACCTTCGAG
AGATACTCGACTTATGATTTGCACGAGTGC|TCGTATCAATTACAGCTACCTCCTGCAGAT
TGGCGCTCTATTAATAACGACCAGACTCGA|TTACACACTGGGTGCGCCGGAGATGTCTCT
AACTCGACTTATGATTTGCACGAGTGCTAG|GCAACCGAATGGTGTGAATGGACGCGTGTC
AGTGAGGGTGATAACCATGACTCGACTTAT|GATTTGCACGAGTGCTAGAAGAGAGGTGTC
TAAGGAACTCGACTTATGATTTGCACGAGT|TTATGATTTGCACGAGTGCTAGATGACACT
TGGTGTGAATGGACGCGTGTCTGCGCATCT|CACCTACTCTCCCACTCGACTTATGATTTG
GCAAATAGGACTCATGTTGGCACAGCCCTG|TAGATACTCGACTTATGATTTGCACGAGTG
GTCGGTGGCGCTCTATTAATAACGACCAGA|CGAGATTACACACTGGGTGCGCCGGAGATG
GAAGGGCTGGAAGGACTCGACTTATGATTT|GGATGTTAGGTTGACGCGAATGCCATAGTT
TAGAGTGAGGGTGATAACCATGACTCGACT|TATGATTTGCACGAGTGCTAGAAGAGAGGT
TGTCCCTTGAAGGGCTGGAAGGACTCGACT|GAGAACGAGGATGTTAGGTTGACGCGAATG
TTATGATTTGCACGAGTGCTAGAAGAGAGG|GGGCATCAACAACCGACTAGGGTATTCATA
TACTCGACTTATGATTTGCACGAGTGCTAG|TATCAATTACAGCTACCTCCTGCAGATCGC
GACTTATGATTTGACTCGACTTATGATTTG|ATCTAGGTCAGTTGCAAATAGGACTCATGT
GATTTGCACGAGTGCTAGAACTCGACTTAT|TGTGAATGGACGCGTGTCTGCGCATCTAGG
AGAGTGCTAGATAGCGAGAAGCAACCGAAT|GTGAAGTCGTAACTTGAGTCGGGCTAAACC
CTCTAGGGCATCAACAACCGACTAGGGTAT|GATAAGGGCGCAGCGACGAAACGCGATATT
TAGGACTCATGTTGGCACAGCCCTGCATTG|ACTCGACTTATGATTTGCACGAGTGCTAGA
AAGATAATCTTTACGGGTCGGTGGCGCTCT|TAGAACCCAATCACTACGAGATTACACACT
TAATCTAACATTGCATCTCTTTACCAGTGG|TATGATTTGCACGAGTGCTAGATATCAACG
GGACTCGACTTATGATTTGCACGAGTGCTA|GACGCGAATGCCATAGTTGGCCCCTGACGT
CGCGAATGCCATAGTTGGCCCCTGACGTCT|TGAGCTCATAATCGGTTCGTGTATTCGCCA
TGCTAGATATCAACGCTAATAGTGGCTATT|CGAATGTGCAAGATAATCTTTACGGGTCGG
CGCTGAGTCCTTGTACGGCGAATGTTGAAT|ACACACTCGACTTATGATTTGCACGAGTGC
TTATGATTTGCACGAGTGCTAGACGAGTCT|AGACCGTCGCGATACACCTGGTGTTGCTAA
GTGCTAGAACTCGACTTATGATTTGCACGA|GCAGATGTCGATCACAGACCGTCGCGATAC
GCTAGATAGCGAGAAGCAACCGAATGGTGT|GTCGTAACTTGAGTCGGGCTAAACCACCTA
CTTATGATTTGCACGAGTGCTAGAGACAAC|TACAGCTACCTCCTGCAGATCGCGCTGAGT
TTTGCACGAGTGCTAGACACGAACTCGACT|ATGTTGGCACAGCCCTGCATTGGTGGTTGG
CCAGCTCGAATGTGCAAGATAATCTTTACG|GATTTGCACGAGTGCTAGAACCCAATCACT
TAGGGCATCAACAACCGACTAGGGTATTCA|AAGGGCGCAGCGACGAAACGCGATATTCGC
TATTAATAACGACCAGACTCGACTTATGAT|TGGGTGCGCCGGAGATGTCTCTAGGGCATC
ACTTATGATTTGCACGAGTGCTAGAGTGCT|TGGACATGAATGTGATCGTTTGGTGAAGTC
CCCAATCACTACGAGATTACACACTGGGTG|CCATATTTCAACCGGGGAATCGCCATAAGT
CAGCTCGAATGTGCAAGATAATCTTTACGG|ATTTGCACGAGTGCTAGAACCCAATCACTA
CTAGATGACACTATTCACGGTATGCCATAA|AGCATAATCTAACATTGCATCTCTTTACCA
GATTTGCACGAGTGCTAGAAGACTAGACGC|CCTTGAAGGGCTGGAAGGACTCGACTTATG
CAACAGGTTGTGGTATCCTAGAGTGAGGGT|TAACGACCAGACTCGACTTATGATTTGCAC
TCCCACTCGACTTATGATTTGCACGAGTGC|AACTCGACTTATGATTTGCACGAGTGCTAG
GCACGAGTGCTAGATCGTATCAATTACAGC|ATGACACTATTCACGGTATGCCATAACGAT
GGTATTCATAGAGAACGAGGATGTTAGGTT|ATATTCGCAGCATTGCCCTATACATTCTAC
CCCCTGACGTCTACCATATTTCAACCGGGG|GTGTATTCGCCAAAAGGACACAGAGGGGTT
CGACTTATGATTTGCACGAGTGCTAGATCG|GCACGAGTGCTAGATGACACTATTCACGGT
ACAGCTACCTCCTGCAGATCGCGCTGAGTC|ACGATTTCCCTCTATGGACTTACACACTCG
TATGATTTGCACGAGTGCTAGAGACAACTG|CAGCTACCTCCTGCAGATCGCGCTGAGTCC
ACTAGACGCCAGCTCGAATGTGCAAGATAA|CGACTTATGATTTGCACGAGTGCTAGAACC
TGCCATAACGATTTCCCTCTATGGACTTAC|CTTTACCAGTGGTTGGCTTAACTCGACTTA
CTTATGATTTGCACGAGTGCTAGAAGACTA|GTGTCCCTTGAAGGGCTGGAAGGACTCGAC
AGTCTAAGCTTGTAAGCATAATCTAACATT|GCTAAATGACACTCGACTTATGATTTGCAC
CGACTTATGATTTGCACGAGTGCTAGACAC|AATAGGACTCATGTTGGCACAGCCCTGCAT
TTTGCACGAGTGCTAGAACCCAATCACTAC|GTTGGCCCCTGACGTCTACCATATTTCAAC
GCTCGAATGTGCAAGATAATCTTTACGGGT|TTGCACGAGTGCTAGAACCCAATCACTACG
TTTGCACGAGTGCTAGACGAGTCTAAGCTT|TCGCGATACACCTGGTGTTGCTAAATGACA
CTCGACTTATGATTTGCACGAGTGCTAGAT|GACTTATGATTTGCACGAGTGCTAGATCGT
AAAGTAAGGAACTCGACTTATGATTTGCAC|CGACTTATGATTTGCACGAGTGCTAGATGA
TATGATTTGCACGAGTGCTAGAAGAGAGGT|GGCATCAACAACCGACTAGGGTATTCATAG
TTACAGCTACCTCCTGCAGATCGCGCTGAG|TAACGATTTCCCTCTATGGACTTACACACT
AGATATCAACGCTAATAGTGGCTATTGCTG|TGTGCAAGATAATCTTTACGGGTCGGTGGC
CTGCAGATGTCGATCACAGACCGTCGCGAT|GGTATCCTAGAGTGAGGGTGATAACCATGA
ATAGTTGGCCCCTGACGTCTACCATATTTC|ATCGGTTCGTGTATTCGCCAAAAGGACACA
GGTTGGCTTAACTCGACTTATGATTTGCAC|CGCTAATAGTGGCTATTGCTGTCTATATGT
TGCACGAGTGCTAGAAGACTAGACGCCAGC|GAAGGGCTGGAAGGACTCGACTTATGATTT
GCTAGAACCCAATCACTACGAGATTACACA|ACGTCTACCATATTTCAACCGGGGAATCGC
GCTATTGCTGTCTATATGTCCAACAGGTTG|GGTCGGTGGCGCTCTATTAATAACGACCAG
AGGTGTCCCTTGAAGGGCTGGAAGGACTCG|ATAGAGAACGAGGATGTTAGGTTGACGCGA
AACCGAATGGTGTGAATGGACGCGTGTCTG|GCTAAACCACCTACTCTCCCACTCGACTTA
AAGAGAGGTGTCCCTTGAAGGGCTGGAAGG|TATTCATAGAGAACGAGGATGTTAGGTTGA
TGTCTCTAGGGCATCAACAACCGACTAGGG|CATGATAAGGGCGCAGCGACGAAACGCGAT
GGCGCAGCGACGAAACGCGATATTCGCAGC|CGCCCAGCCAGCTCGATGATTCAACGTAGA
GGTTGTGGTATCCTAGAGTGAGGGTGATAA|ACCAGACTCGACTTATGATTTGCACGAGTG
TTGGCCCCTGACGTCTACCATATTTCAACC|GTTCGTGTATTCGCCAAAAGGACACAGAGG
CAGCGACGAAACGCGATATTCGCAGCATTG|CAGCCAGCTCGATGATTCAACGTAGAGCAA
ACCTCCTGCAGATCGCGCTGAGTCCTTGTA|TCCCTCTATGGACTTACACACTCGACTTAT
GAACCCAATCACTACGAGATTACACACTGG|CTACCATATTTCAACCGGGGAATCGCCATA
ACGGTATGCCATAACGATTTCCCTCTATGG|GCATCTCTTTACCAGTGGTTGGCTTAACTC
AAGATAAATCAATAGTAGAAAGACCGACTA|TTGTTCGAGGGGGTGTGCTCACCCAGACTC
GAATTGTTCGAGGGGGTGTGCTCACCCAGA|GTGCTAGAACTCGACTTATGATTTGCACGA
ATCCTAGAGTGAGGGTGATAACCATGACTC|GACTTATGATTTGCACGAGTGCTAGAAGAG
CTTTACCAGTGGTTGGCTTAACTCGACTTA|TAGATATCAACGCTAATAGTGGCTATTGCT
AATGTAGAATCCAAGATAAATCAATAGTAG|GCGAATGTTGAATTGTTCGAGGGGGTGTGC
ATGTGCAAGATAATCTTTACGGGTCGGTGG|GAGTGCTAGAACCCAATCACTACGAGATTA
CAACGCTAATAGTGGCTATTGCTGTCTATA|AGATAATCTTTACGGGTCGGTGGCGCTCTA
GCGAATGTAGAATCCAAGATAAATCAATAG|ACGGCGAATGTTGAATTGTTCGAGGGGGTG
AACGCTAATAGTGGCTATTGCTGTCTATAT|GATAATCTTTACGGGTCGGTGGCGCTCTAT
AGTGCTAGATCGTATCAATTACAGCTACCT|ACTATTCACGGTATGCCATAACGATTTCCC
CTGGAAGGACTCGACTTATGATTTGCACGA|TAGGTTGACGCGAATGCCATAGTTGGCCCC
GTGCTAGACGAGTCTAAGCTTGTAAGCATA|ACCTGGTGTTGCTAAATGACACTCGACTTA
TTATGATTTGACTCGACTTATGATTTGCAC|TAGGTCAGTTGCAAATAGGACTCATGTTGG
GTGAGGGTGATAACCATGACTCGACTTATG|ATTTGCACGAGTGCTAGAAGAGAGGTGTCC
CATAACGATTTCCCTCTATGGACTTACACA|TACCAGTGGTTGGCTTAACTCGACTTATGA
ATGATTTGCACGAGTGCTAGAAGACTAGAC|TCCCTTGAAGGGCTGGAAGGACTCGACTTA
ACGGGTCGGTGGCGCTCTATTAATAACGAC|ACTACGAGATTACACACTGGGTGCGCCGGA
ATGATTTGCACGAGTGCTAGAACCCAATCA|CATAGTTGGCCCCTGACGTCTACCATATTT
GCAGATGTCGATCACAGACCGTCGCGATAC|TATCCTAGAGTGAGGGTGATAACCATGACT
ACACTATTCACGGTATGCCATAACGATTTC|TCTAACATTGCATCTCTTTACCAGTGGTTG
TGCTAGAACTCGACTTATGATTTGCACGAG|CAGATGTCGATCACAGACCGTCGCGATACA
AGGTTGACGCGAATGCCATAGTTGGCCCCT|TCTACCGTGAGCTCATAATCGGTTCGTGTA
AATCGCCATAAGTTTCACGTACCATGATAA|ACTAGACACTCAGAAACCTTCGAGGGGGCT
ATGATTTGCACGAGTGCTAGACCCTGCAGA|TGTCTATATGTCCAACAGGTTGTGGTATCC
GACTTATGATTTGCACGAGTGCTAGATATC|AGAAGACTAGACGCCAGCTCGAATGTGCAA
TGTAAGCATAATCTAACATTGCATCTCTTT|ACTCGACTTATGATTTGCACGAGTGCTAGA
GACATGAATGTGATCGTTTGGTGAAGTCGT|GTGAAGCGAATGTAGAATCCAAGATAAATC
TGCACGAGTGCTAGAGTGCTAGATAGCGAG|TGTGATCGTTTGGTGAAGTCGTAACTTGAG
ACACACTGGGTGCGCCGGAGATGTCTCTAG|ATCGCCATAAGTTTCACGTACCATGATAAG
GCTAGATACTCGACTTATGATTTGCACGAG|AGATCGTATCAATTACAGCTACCTCCTGCA
TTTCACGTACCATGATAAGGGCGCAGCGAC|GAAACCTTCGAGGGGGCTTCGCCCAGCCAG
CTACGAGATTACACACTGGGTGCGCCGGAG|CAACCGGGGAATCGCCATAAGTTTCACGTA
AGCGAGAAGCAACCGAATGGTGTGAATGGA|CTTGAGTCGGGCTAAACCACCTACTCTCCC
GCTAGATATCAACGCTAATAGTGGCTATTG|GAATGTGCAAGATAATCTTTACGGGTCGGT
ACCTGGTGTTGCTAAATGACACTCGACTTA|CGACTTATGATTTGCACGAGTGCTAGAAGA
AGTGCTAGAAGAGAGGTGTCCCTTGAAGGG|GACTAGGGTATTCATAGAGAACGAGGATGT
GATGACACTATTCACGGTATGCCATAACGA|ATAATCTAACATTGCATCTCTTTACCAGTG
GTGCTAGATACTCGACTTATGATTTGCACG|CTAGATCGTATCAATTACAGCTACCTCCTG
ACGAGTGCTAGACGAGTCTAAGCTTGTAAG|ATACACCTGGTGTTGCTAAATGACACTCGA
ACAACTGTGAAGCGAATGTAGAATCCAAGA|TGAGTCCTTGTACGGCGAATGTTGAATTGT
AAAACTCGACTTATGATTTGCACGAGTGCT|AAGCAACCGAATGGTGTGAATGGACGCGTG
GATAGCGAGAAGCAACCGAATGGTGTGAAT|TAACTTGAGTCGGGCTAAACCACCTACTCT
TGCTAGACACGAACTCGACTTATGATTTGC|AGCCCTGCATTGGTGGTTGGACATGAATGT
GACTCGACTTATGATTTGCACGAGTGCTAG|ACGCGAATGCCATAGTTGGCCCCTGACGTC
ACGAGGATGTTAGGTTGACGCGAATGCCAT|GCCCTATACATTCTACCGTGAGCTCATAAT
AGTGCTAGACACGAACTCGACTTATGATTT|ACAGCCCTGCATTGGTGGTTGGACATGAAT
GACGAGTCTAAGCTTGTAAGCATAATCTAA|TGTTGCTAAATGACACTCGACTTATGATTT
ATTTGCACGAGTGCTAGACGAGTCTAAGCT|GTCGCGATACACCTGGTGTTGCTAAATGAC
AACTCGACTTATGATTTGACTCGACTTATG|TGCGCATCTAGGTCAGTTGCAAATAGGACT
GACTCGACTTATGATTTGCACGAGTGCTAG|TGCAAATAGGACTCATGTTGGCACAGCCCT
GACTTATGATTTGCACGAGTGCTAGATACT|TTATGATTTGCACGAGTGCTAGATCGTATC
GATTTGCACGAGTGCTAGACACGAACTCGA|TCATGTTGGCACAGCCCTGCATTGGTGGTT
TACACACTGGGTGCGCCGGAGATGTCTCTA|AATCGCCATAAGTTTCACGTACCATGATAA
ACTAAAGTAAGGAACTCGACTTATGATTTG|ACTCGACTTATGATTTGCACGAGTGCTAGA
TTCAACCGGGGAATCGCCATAAGTTTCACG|ACAGAGGGGTTACTAGACACTCAGAAACCT
ACTTATGATTTGCACGAGTGCTAGAAGACT|GGTGTCCCTTGAAGGGCTGGAAGGACTCGA
TGATAACCATGACTCGACTTATGATTTGCA|CGAGTGCTAGAAGAGAGGTGTCCCTTGAAG
ACCCAATCACTACGAGATTACACACTGGGT|ACCATATTTCAACCGGGGAATCGCCATAAG
GCACGAGTGCTAGATGACACTATTCACGGT|AAGCTTGTAAGCATAATCTAACATTGCATC
TACAGCTACCTCCTGCAGATCGCGCTGAGT|AACGATTTCCCTCTATGGACTTACACACTC
TCAACAACCGACTAGGGTATTCATAGAGAA|CAGCGACGAAACGCGATATTCGCAGCATTG
GAAAGACCGACTAAAGTAAGGAACTCGACT|CTCACCCAGACTCGACTTATGATTTGCACG
CACGAGTGCTAGATCGTATCAATTACAGCT|TGACACTATTCACGGTATGCCATAACGATT
TTTGCACGAGTGCTAGATACTCGACTTATG|GCACGAGTGCTAGATCGTATCAATTACAGC
GCTAGAACTCGACTTATGATTTGCACGAGT|AGATGTCGATCACAGACCGTCGCGATACAC
GCACAGCCCTGCATTGGTGGTTGGACATGA|TTGCACGAGTGCTAGAGACAACTGTGAAGC
CGAGTGCTAGACACGAACTCGACTTATGAT|GCACAGCCCTGCATTGGTGGTTGGACATGA
AATGCCATAGTTGGCCCCTGACGTCTACCA|CTCATAATCGGTTCGTGTATTCGCCAAAAG
GAGTGCTAGATACTCGACTTATGATTTGCA|TGCTAGATCGTATCAATTACAGCTACCTCC
TTGAATTGTTCGAGGGGGTGTGCTCACCCA|GAGTGCTAGAACTCGACTTATGATTTGCAC
TATGATTTGCACGAGTGCTAGACCCTGCAG|CTGTCTATATGTCCAACAGGTTGTGGTATC
GGTGTTGCTAAATGACACTCGACTTATGAT|TTATGATTTGCACGAGTGCTAGAAGACTAG
GGCCCCTGACGTCTACCATATTTCAACCGG|TCGTGTATTCGCCAAAAGGACACAGAGGGG
CGACTTATGATTTGCACGAGTGCTAGAACT|CCGAATGGTGTGAATGGACGCGTGTCTGCG
TAAAGTAAGGAACTCGACTTATGATTTGCA|TCGACTTATGATTTGCACGAGTGCTAGATG
GGAATCGCCATAAGTTTCACGTACCATGAT|TTACTAGACACTCAGAAACCTTCGAGGGGG
TCGCGCTGAGTCCTTGTACGGCGAATGTTG|CTTACACACTCGACTTATGATTTGCACGAG
GCTGAGTCCTTGTACGGCGAATGTTGAATT|CACACTCGACTTATGATTTGCACGAGTGCT
GACGTCTACCATATTTCAACCGGGGAATCG|TTCGCCAAAAGGACACAGAGGGGTTACTAG
TTGTGGTATCCTAGAGTGAGGGTGATAACC|CAGACTCGACTTATGATTTGCACGAGTGCT
CCCAGACTCGACTTATGATTTGCACGAGTG|GCACGAGTGCTAGACGAGTCTAAGCTTGTA
AGTGCTAGAACTCGACTTATGATTTGCACG|TGCAGATGTCGATCACAGACCGTCGCGATA
ACGACCAGACTCGACTTATGATTTGCACGA|CCGGAGATGTCTCTAGGGCATCAACAACCG
CTGCAGATCGCGCTGAGTCCTTGTACGGCG|CTATGGACTTACACACTCGACTTATGATTT
GACTCGACTTATGATTTGCACGAGTGCTAG|AAGAGAGGTGTCCCTTGAAGGGCTGGAAGG
AATGTGATCGTTTGGTGAAGTCGTAACTTG|CGAATGTAGAATCCAAGATAAATCAATAGT
GTCTCTAGGGCATCAACAACCGACTAGGGT|ATGATAAGGGCGCAGCGACGAAACGCGATA
GGGGTGTGCTCACCCAGACTCGACTTATGA|GACTTATGATTTGCACGAGTGCTAGACGAG
ATGATTTGCACGAGTGCTAGAGACAACTGT|AGCTACCTCCTGCAGATCGCGCTGAGTCCT
ACCGGGGAATCGCCATAAGTTTCACGTACC|AGGGGTTACTAGACACTCAGAAACCTTCGA
TGTTGCTAAATGACACTCGACTTATGATTT|ATGATTTGCACGAGTGCTAGAAGACTAGAC
TATATGTCCAACAGGTTGTGGTATCCTAGA|TCTATTAATAACGACCAGACTCGACTTATG
CTCGACTTATGATTTGCACGAGTGCTAGAA|GAGAGGTGTCCCTTGAAGGGCTGGAAGGAC
GTCCAACAGGTTGTGGTATCCTAGAGTGAG|TAATAACGACCAGACTCGACTTATGATTTG
GCACGAGTGCTAGAGTGCTAGATAGCGAGA|GTGATCGTTTGGTGAAGTCGTAACTTGAGT
TAGAAGACTAGACGCCAGCTCGAATGTGCA|AGGACTCGACTTATGATTTGCACGAGTGCT
ATAACGATTTCCCTCTATGGACTTACACAC|ACCAGTGGTTGGCTTAACTCGACTTATGAT
GCGAATGCCATAGTTGGCCCCTGACGTCTA|GAGCTCATAATCGGTTCGTGTATTCGCCAA
GAGTGCTAGAAGACTAGACGCCAGCTCGAA|GCTGGAAGGACTCGACTTATGATTTGCACG
GCACGAGTGCTAGATATCAACGCTAATAGT|GCCAGCTCGAATGTGCAAGATAATCTTTAC
GTCTGCGCATCTAGGTCAGTTGCAAATAGG|ACTTATGATTTGCACGAGTGCTAGATACTC
TCGACTTATGATTTGCACGAGTGCTAGAAG|CTCTAGGGCATCAACAACCGACTAGGGTAT
CACGAGTGCTAGATGACACTATTCACGGTA|AGCTTGTAAGCATAATCTAACATTGCATCT
AGGGCTGGAAGGACTCGACTTATGATTTGC|ATGTTAGGTTGACGCGAATGCCATAGTTGG
TGCACGAGTGCTAGAACTCGACTTATGATT|AGACCCTGCAGATGTCGATCACAGACCGTC
TGCTAGAACCCAATCACTACGAGATTACAC|GACGTCTACCATATTTCAACCGGGGAATCG
TGCACGAGTGCTAGATCGTATCAATTACAG|GATGACACTATTCACGGTATGCCATAACGA
GCACGAGTGCTAGAAGAGAGGTGTCCCTTG|CAACCGACTAGGGTATTCATAGAGAACGAG
AGTGCTAGAACTCGACTTATGATTTGACTC|CGCGTGTCTGCGCATCTAGGTCAGTTGCAA
ATGGACTTACACACTCGACTTATGATTTGC|ACTCGACTTATGATTTGCACGAGTGCTAGA
ACGTACCATGATAAGGGCGCAGCGACGAAA|CCTTCGAGGGGGCTTCGCCCAGCCAGCTCG
CAAGATAAATCAATAGTAGAAAGACCGACT|ATTGTTCGAGGGGGTGTGCTCACCCAGACT
ACGAGTGCTAGAGTGCTAGATAGCGAGAAG|GATCGTTTGGTGAAGTCGTAACTTGAGTCG
CTAGAACTCGACTTATGATTTGCACGAGTG|GATGTCGATCACAGACCGTCGCGATACACC
TATGATTTGCACGAGTGCTAGAAGACTAGA|GTCCCTTGAAGGGCTGGAAGGACTCGACTT
CGAGTGCTAGATACTCGACTTATGATTTGC|GTGCTAGATCGTATCAATTACAGCTACCTC
TTGGCACAGCCCTGCATTGGTGGTTGGACA|GATTTGCACGAGTGCTAGAGACAACTGTGA
GATTTGCACGAGTGCTAGATATCAACGCTA|TAGACGCCAGCTCGAATGTGCAAGATAATC
ATGATTTGCACGAGTGCTAGAACTCGACTT|GGTGTGAATGGACGCGTGTCTGCGCATCTA
CATTGCATCTCTTTACCAGTGGTTGGCTTA|GCACGAGTGCTAGATATCAACGCTAATAGT
ATCAATTACAGCTACCTCCTGCAGATCGCG|TGCCATAACGATTTCCCTCTATGGACTTAC
TAAGCATAATCTAACATTGCATCTCTTTAC|TCGACTTATGATTTGCACGAGTGCTAGATA
CATAAGTTTCACGTACCATGATAAGGGCGC|CACTCAGAAACCTTCGAGGGGGCTTCGCCC
GTTGGACATGAATGTGATCGTTTGGTGAAG|AACTGTGAAGCGAATGTAGAATCCAAGATA
ATGACACTCGACTTATGATTTGCACGAGTG|ACGAGTGCTAGAAGACTAGACGCCAGCTCG
ACTCGACTTATGATTTGCACGAGTGCTAGA|GTGGTTGGACATGAATGTGATCGTTTGGTG
GCTAGAACTCGACTTATGATTTGACTCGAC|GTGTCTGCGCATCTAGGTCAGTTGCAAATA
AGCCCTGCATTGGTGGTTGGACATGAATGT|ACGAGTGCTAGAGACAACTGTGAAGCGAAT
ACACCTGGTGTTGCTAAATGACACTCGACT|CTCGACTTATGATTTGCACGAGTGCTAGAA
CGACTAAAGTAAGGAACTCGACTTATGATT|AGACTCGACTTATGATTTGCACGAGTGCTA
GCCGGAGATGTCTCTAGGGCATCAACAACC|TCACGTACCATGATAAGGGCGCAGCGACGA
CCAGTGGTTGGCTTAACTCGACTTATGATT|ATCAACGCTAATAGTGGCTATTGCTGTCTA
TACGGGTCGGTGGCGCTCTATTAATAACGA|CACTACGAGATTACACACTGGGTGCGCCGG
ACACACTCGACTTATGATTTGCACGAGTGC|TATGATTTGCACGAGTGCTAGACCCTGCAG
GACTTATGATTTGCACGAGTGCTAGAAGAG|CTAGGGCATCAACAACCGACTAGGGTATTC
GAGAAGCAACCGAATGGTGTGAATGGACGC|GAGTCGGGCTAAACCACCTACTCTCCCACT
GCCATAGTTGGCCCCTGACGTCTACCATAT|ATAATCGGTTCGTGTATTCGCCAAAAGGAC
CTGAGTCCTTGTACGGCGAATGTTGAATTG|ACACTCGACTTATGATTTGCACGAGTGCTA
ACAGACCGTCGCGATACACCTGGTGTTGCT|GGGTGATAACCATGACTCGACTTATGATTT
TAGACGCCAGCTCGAATGTGCAAGATAATC|ACTTATGATTTGCACGAGTGCTAGAACCCA
GTTGAATTGTTCGAGGGGGTGTGCTCACCC|CGAGTGCTAGAACTCGACTTATGATTTGCA
GTGCTAGAGTGCTAGATAGCGAGAAGCAAC|GTTTGGTGAAGTCGTAACTTGAGTCGGGCT
GTGTCTGCGCATCTAGGTCAGTTGCAAATA|CGACTTATGATTTGCACGAGTGCTAGATAC
ACTTATGATTTGCACGAGTGCTAGATATCA|GAAGACTAGACGCCAGCTCGAATGTGCAAG
TATGATTTGACTCGACTTATGATTTGCACG|AGGTCAGTTGCAAATAGGACTCATGTTGGC
ATAATCTAACATTGCATCTCTTTACCAGTG|TTATGATTTGCACGAGTGCTAGATATCAAC
AGTGCTAGACCCTGCAGATGTCGATCACAG|CAACAGGTTGTGGTATCCTAGAGTGAGGGT
ATAAGGGCGCAGCGACGAAACGCGATATTC|GGCTTCGCCCAGCCAGCTCGATGATTCAAC
CTTATGATTTGCACGAGTGCTAGATACTCG|ATGATTTGCACGAGTGCTAGATCGTATCAA
TGAAGGGCTGGAAGGACTCGACTTATGATT|AGGATGTTAGGTTGACGCGAATGCCATAGT
ATGTTAGGTTGACGCGAATGCCATAGTTGG|TACATTCTACCGTGAGCTCATAATCGGTTC
ACTTATGATTTGCACGAGTGCTAGAGACAA|TTACAGCTACCTCCTGCAGATCGCGCTGAG
GACTTATGATTTGCACGAGTGCTAGAACTC|GCACGAGTGCTAGACCCTGCAGATGTCGAT
TAGAACTCGACTTATGATTTGCACGAGTGC|ATGTCGATCACAGACCGTCGCGATACACCT
GCATTGGTGGTTGGACATGAATGTGATCGT|GCTAGAGACAACTGTGAAGCGAATGTAGAA
CTCCCACTCGACTTATGATTTGCACGAGTG|GAACTCGACTTATGATTTGCACGAGTGCTA
CGTATCAATTACAGCTACCTCCTGCAGATC|GTATGCCATAACGATTTCCCTCTATGGACT
ATATGTCCAACAGGTTGTGGTATCCTAGAG|CTATTAATAACGACCAGACTCGACTTATGA
CAGATCGCGCTGAGTCCTTGTACGGCGAAT|TGGACTTACACACTCGACTTATGATTTGCA
GACGCCAGCTCGAATGTGCAAGATAATCTT|TTATGATTTGCACGAGTGCTAGAACCCAAT
TAGAAGAGAGGTGTCCCTTGAAGGGCTGGA|GGGTATTCATAGAGAACGAGGATGTTAGGT
GATATCAACGCTAATAGTGGCTATTGCTGT|GTGCAAGATAATCTTTACGGGTCGGTGGCG
TCAGTTGCAAATAGGACTCATGTTGGCACA|GAGTGCTAGATACTCGACTTATGATTTGCA
ATGATTTGACTCGACTTATGATTTGCACGA|GGTCAGTTGCAAATAGGACTCATGTTGGCA
ACGCGTGTCTGCGCATCTAGGTCAGTTGCA|CACTCGACTTATGATTTGCACGAGTGCTAG
GCTAGAGACAACTGTGAAGCGAATGTAGAA|ATCGCGCTGAGTCCTTGTACGGCGAATGTT
TTGCATCTCTTTACCAGTGGTTGGCTTAAC|ACGAGTGCTAGATATCAACGCTAATAGTGG
GATGTCGATCACAGACCGTCGCGATACACC|CCTAGAGTGAGGGTGATAACCATGACTCGA
ACCAGACTCGACTTATGATTTGCACGAGTG|GAGATGTCTCTAGGGCATCAACAACCGACT
TTTGGTGAAGTCGTAACTTGAGTCGGGCTA|ATCCAAGATAAATCAATAGTAGAAAGACCG
CGACTTATGATTTGCACGAGTGCTAGAACC|GAATGCCATAGTTGGCCCCTGACGTCTACC
ATGTGATCGTTTGGTGAAGTCGTAACTTGA|GAATGTAGAATCCAAGATAAATCAATAGTA
TAGTTGGCCCCTGACGTCTACCATATTTCA|TCGGTTCGTGTATTCGCCAAAAGGACACAG
GCGCTCTATTAATAACGACCAGACTCGACT|ACACACTGGGTGCGCCGGAGATGTCTCTAG
ACGAGTGCTAGATCGTATCAATTACAGCTA|GACACTATTCACGGTATGCCATAACGATTT
CGAGTGCTAGAAGAGAGGTGTCCCTTGAAG|CCGACTAGGGTATTCATAGAGAACGAGGAT
TGATTTGCACGAGTGCTAGAACTCGACTTA|GTGTGAATGGACGCGTGTCTGCGCATCTAG
TGAAGCGAATGTAGAATCCAAGATAAATCA|TTGTACGGCGAATGTTGAATTGTTCGAGGG
TCTCCCACTCGACTTATGATTTGCACGAGT|GGAACTCGACTTATGATTTGCACGAGTGCT
ATAAATCAATAGTAGAAAGACCGACTAAAG|TTCGAGGGGGTGTGCTCACCCAGACTCGAC
GAGATTACACACTGGGTGCGCCGGAGATGT|CGGGGAATCGCCATAAGTTTCACGTACCAT
GACTCATGTTGGCACAGCCCTGCATTGGTG|CGACTTATGATTTGCACGAGTGCTAGAGAC
TGCGCATCTAGGTCAGTTGCAAATAGGACT|TATGATTTGCACGAGTGCTAGATACTCGAC
TTGCTGTCTATATGTCCAACAGGTTGTGGT|GGTGGCGCTCTATTAATAACGACCAGACTC
GTTGGCTTAACTCGACTTATGATTTGCACG|GCTAATAGTGGCTATTGCTGTCTATATGTC
AGTGCTAGATGACACTATTCACGGTATGCC|TGTAAGCATAATCTAACATTGCATCTCTTT
CTTGAAGGGCTGGAAGGACTCGACTTATGA|CGAGGATGTTAGGTTGACGCGAATGCCATA
GCTCACCCAGACTCGACTTATGATTTGCAC|GATTTGCACGAGTGCTAGACGAGTCTAAGC
TCTTTACGGGTCGGTGGCGCTCTATTAATA|CAATCACTACGAGATTACACACTGGGTGCG
AGATCGCGCTGAGTCCTTGTACGGCGAATG|GGACTTACACACTCGACTTATGATTTGCAC
CAAGATAATCTTTACGGGTCGGTGGCGCTC|CTAGAACCCAATCACTACGAGATTACACAC
TGATTTGCACGAGTGCTAGAACTCGACTTA|GTGCTAGACCCTGCAGATGTCGATCACAGA
GCGCAGCGACGAAACGCGATATTCGCAGCA|GCCCAGCCAGCTCGATGATTCAACGTAGAG
CTAGAGTGAGGGTGATAACCATGACTCGAC|TTATGATTTGCACGAGTGCTAGAAGAGAGG
CATCTAGGTCAGTTGCAAATAGGACTCATG|ATTTGCACGAGTGCTAGATACTCGACTTAT
TCAATTACAGCTACCTCCTGCAGATCGCGC|GCCATAACGATTTCCCTCTATGGACTTACA
GACCGACTAAAGTAAGGAACTCGACTTATG|CCCAGACTCGACTTATGATTTGCACGAGTG
TGCTAGATGACACTATTCACGGTATGCCAT|TAAGCATAATCTAACATTGCATCTCTTTAC
AACTCGACTTATGATTTGCACGAGTGCTAG|GGTGGTTGGACATGAATGTGATCGTTTGGT
CATGAATGTGATCGTTTGGTGAAGTCGTAA|GAAGCGAATGTAGAATCCAAGATAAATCAA
TATGATTTGCACGAGTGCTAGATATCAACG|GACTAGACGCCAGCTCGAATGTGCAAGATA
AGACCGTCGCGATACACCTGGTGTTGCTAA|GTGATAACCATGACTCGACTTATGATTTGC
TTACGGGTCGGTGGCGCTCTATTAATAACG|TCACTACGAGATTACACACTGGGTGCGCCG
ATTTGCACGAGTGCTAGAACTCGACTTATG|GTGAATGGACGCGTGTCTGCGCATCTAGGT
TGATTTGCACGAGTGCTAGACACGAACTCG|CTCATGTTGGCACAGCCCTGCATTGGTGGT
ATCACAGACCGTCGCGATACACCTGGTGTT|TGAGGGTGATAACCATGACTCGACTTATGA
ATTGTTCGAGGGGGTGTGCTCACCCAGACT|GCTAGAACTCGACTTATGATTTGCACGAGT
AGTGCTAGAAGACTAGACGCCAGCTCGAAT|CTGGAAGGACTCGACTTATGATTTGCACGA
GCTAAACCACCTACTCTCCCACTCGACTTA|ACCGACTAAAGTAAGGAACTCGACTTATGA
CCACTCGACTTATGATTTGCACGAGTGCTA|CTCGACTTATGATTTGCACGAGTGCTAGAT
TAACGATTTCCCTCTATGGACTTACACACT|CCAGTGGTTGGCTTAACTCGACTTATGATT
CGAGTGCTAGAACTCGACTTATGATTTGCA|CCTGCAGATGTCGATCACAGACCGTCGCGA
GGGCTAAACCACCTACTCTCCCACTCGACT|AGACCGACTAAAGTAAGGAACTCGACTTAT
TCGACTTATGATTTGCACGAGTGCTAGATA|ACTTATGATTTGCACGAGTGCTAGATCGTA
TTTGCACGAGTGCTAGATCGTATCAATTAC|TAGATGACACTATTCACGGTATGCCATAAC
AATTGTTCGAGGGGGTGTGCTCACCCAGAC|TGCTAGAACTCGACTTATGATTTGCACGAG
ATGATTTGCACGAGTGCTAGATATCAACGC|ACTAGACGCCAGCTCGAATGTGCAAGATAA
ATAGCGAGAAGCAACCGAATGGTGTGAATG|AACTTGAGTCGGGCTAAACCACCTACTCTC
TCATAGAGAACGAGGATGTTAGGTTGACGC|CGCAGCATTGCCCTATACATTCTACCGTGA
ACTCGACTTATGATTTGACTCGACTTATGA|GCGCATCTAGGTCAGTTGCAAATAGGACTC
ATGGTGTGAATGGACGCGTGTCTGCGCATC|CCACCTACTCTCCCACTCGACTTATGATTT
GTTGGCCCCTGACGTCTACCATATTTCAAC|GGTTCGTGTATTCGCCAAAAGGACACAGAG
GAATGGACGCGTGTCTGCGCATCTAGGTCA|CTCTCCCACTCGACTTATGATTTGCACGAG
TTATGATTTGCACGAGTGCTAGATATCAAC|AGACTAGACGCCAGCTCGAATGTGCAAGAT
GAGTGCTAGATCGTATCAATTACAGCTACC|CACTATTCACGGTATGCCATAACGATTTCC
CGAGGATGTTAGGTTGACGCGAATGCCATA|CCCTATACATTCTACCGTGAGCTCATAATC
CCCTTGAAGGGCTGGAAGGACTCGACTTAT|AACGAGGATGTTAGGTTGACGCGAATGCCA
AATGTGCAAGATAATCTTTACGGGTCGGTG|CGAGTGCTAGAACCCAATCACTACGAGATT
ACTCGACTTATGATTTGCACGAGTGCTAGA|CAACCGAATGGTGTGAATGGACGCGTGTCT
GTGTTGCTAAATGACACTCGACTTATGATT|TATGATTTGCACGAGTGCTAGAAGACTAGA
AAATCAATAGTAGAAAGACCGACTAAAGTA|CGAGGGGGTGTGCTCACCCAGACTCGACTT
GGTGTGAATGGACGCGTGTCTGCGCATCTA|ACCTACTCTCCCACTCGACTTATGATTTGC
GAGTGCTAGAACTCGACTTATGATTTGACT|ACGCGTGTCTGCGCATCTAGGTCAGTTGCA
TGACGTCTACCATATTTCAACCGGGGAATC|ATTCGCCAAAAGGACACAGAGGGGTTACTA
TTTGCACGAGTGCTAGACCCTGCAGATGTC|TATATGTCCAACAGGTTGTGGTATCCTAGA
AGGGTGATAACCATGACTCGACTTATGATT|TGCACGAGTGCTAGAAGAGAGGTGTCCCTT
CCATAGTTGGCCCCTGACGTCTACCATATT|TAATCGGTTCGTGTATTCGCCAAAAGGACA
GCTAGACACGAACTCGACTTATGATTTGCA|GCCCTGCATTGGTGGTTGGACATGAATGTG
GAGAGGTGTCCCTTGAAGGGCTGGAAGGAC|TTCATAGAGAACGAGGATGTTAGGTTGACG
AGAGTGAGGGTGATAACCATGACTCGACTT|ATGATTTGCACGAGTGCTAGAAGAGAGGTG
TAGATACTCGACTTATGATTTGCACGAGTG|ATCGTATCAATTACAGCTACCTCCTGCAGA
TCGACTTATGATTTGCACGAGTGCTAGAAC|ACCGAATGGTGTGAATGGACGCGTGTCTGC
TGCACGAGTGCTAGATACTCGACTTATGAT|ACGAGTGCTAGATCGTATCAATTACAGCTA
CTACTCTCCCACTCGACTTATGATTTGCAC|GTAAGGAACTCGACTTATGATTTGCACGAG
TGCACGAGTGCTAGATGACACTATTCACGG|TAAGCTTGTAAGCATAATCTAACATTGCAT
AGTAGAAAGACCGACTAAAGTAAGGAACTC|TGTGCTCACCCAGACTCGACTTATGATTTG
TTTGCACGAGTGCTAGAAGACTAGACGCCA|TTGAAGGGCTGGAAGGACTCGACTTATGAT
AGCTTGTAAGCATAATCTAACATTGCATCT|TGACACTCGACTTATGATTTGCACGAGTGC
CGAATGTTGAATTGTTCGAGGGGGTGTGCT|TTGCACGAGTGCTAGAACTCGACTTATGAT
CGACTAGGGTATTCATAGAGAACGAGGATG|AAACGCGATATTCGCAGCATTGCCCTATAC
ATTGGTGGTTGGACATGAATGTGATCGTTT|TAGAGACAACTGTGAAGCGAATGTAGAATC
ATGATTTGCACGAGTGCTAGATGACACTAT|CGAGTCTAAGCTTGTAAGCATAATCTAACA
AGCGAATGTAGAATCCAAGATAAATCAATA|TACGGCGAATGTTGAATTGTTCGAGGGGGT
GCTAGAAGAGAGGTGTCCCTTGAAGGGCTG|TAGGGTATTCATAGAGAACGAGGATGTTAG
AACCACCTACTCTCCCACTCGACTTATGAT|ACTAAAGTAAGGAACTCGACTTATGATTTG
CGAATGTGCAAGATAATCTTTACGGGTCGG|CACGAGTGCTAGAACCCAATCACTACGAGA
TTTGCACGAGTGCTAGATGACACTATTCAC|TCTAAGCTTGTAAGCATAATCTAACATTGC
AGACTCGACTTATGATTTGCACGAGTGCTA|ATGTCTCTAGGGCATCAACAACCGACTAGG
GTTTGGTGAAGTCGTAACTTGAGTCGGGCT|AATCCAAGATAAATCAATAGTAGAAAGACC
TGTGCAAGATAATCTTTACGGGTCGGTGGC|AGTGCTAGAACCCAATCACTACGAGATTAC
GCTGTCTATATGTCCAACAGGTTGTGGTAT|TGGCGCTCTATTAATAACGACCAGACTCGA
CTTATGATTTGCACGAGTGCTAGACCCTGC|TGCTGTCTATATGTCCAACAGGTTGTGGTA
TTGGACATGAATGTGATCGTTTGGTGAAGT|ACTGTGAAGCGAATGTAGAATCCAAGATAA
GGCACAGCCCTGCATTGGTGGTTGGACATG|TTTGCACGAGTGCTAGAGACAACTGTGAAG
ATTGCATCTCTTTACCAGTGGTTGGCTTAA|CACGAGTGCTAGATATCAACGCTAATAGTG
TATGATTTGCACGAGTGCTAGAGTGCTAGA|ACATGAATGTGATCGTTTGGTGAAGTCGTA
GCTAAATGACACTCGACTTATGATTTGCAC|TTTGCACGAGTGCTAGAAGACTAGACGCCA
CCTGCATTGGTGGTTGGACATGAATGTGAT|AGTGCTAGAGACAACTGTGAAGCGAATGTA
TGTTCGAGGGGGTGTGCTCACCCAGACTCG|TAGAACTCGACTTATGATTTGCACGAGTGC
TTGTTCGAGGGGGTGTGCTCACCCAGACTC|CTAGAACTCGACTTATGATTTGCACGAGTG
ACTCATGTTGGCACAGCCCTGCATTGGTGG|GACTTATGATTTGCACGAGTGCTAGAGACA
GCACGAGTGCTAGAACCCAATCACTACGAG|GGCCCCTGACGTCTACCATATTTCAACCGG
TGCATCTCTTTACCAGTGGTTGGCTTAACT|CGAGTGCTAGATATCAACGCTAATAGTGGC
CGAACTCGACTTATGATTTGCACGAGTGCT|TTGGTGGTTGGACATGAATGTGATCGTTTG
ATGCCATAACGATTTCCCTCTATGGACTTA|TCTTTACCAGTGGTTGGCTTAACTCGACTT
GATTTGACTCGACTTATGATTTGCACGAGT|TCAGTTGCAAATAGGACTCATGTTGGCACA
TTGAGTCGGGCTAAACCACCTACTCTCCCA|AGTAGAAAGACCGACTAAAGTAAGGAACTC
CTTACACACTCGACTTATGATTTGCACGAG|ACTTATGATTTGCACGAGTGCTAGACCCTG
TGGACATGAATGTGATCGTTTGGTGAAGTC|CTGTGAAGCGAATGTAGAATCCAAGATAAA
CGACTTATGATTTGCACGAGTGCTAGAGAC|AATTACAGCTACCTCCTGCAGATCGCGCTG
ATCGTATCAATTACAGCTACCTCCTGCAGA|CGGTATGCCATAACGATTTCCCTCTATGGA
CTAGATATCAACGCTAATAGTGGCTATTGC|AATGTGCAAGATAATCTTTACGGGTCGGTG
GATAAATCAATAGTAGAAAGACCGACTAAA|GTTCGAGGGGGTGTGCTCACCCAGACTCGA
AGAGACAACTGTGAAGCGAATGTAGAATCC|GCGCTGAGTCCTTGTACGGCGAATGTTGAA
ATGTCTCTAGGGCATCAACAACCGACTAGG|CCATGATAAGGGCGCAGCGACGAAACGCGA
ATTTGCACGAGTGCTAGAACCCAATCACTA|AGTTGGCCCCTGACGTCTACCATATTTCAA
CACCTGGTGTTGCTAAATGACACTCGACTT|TCGACTTATGATTTGCACGAGTGCTAGAAG
CAGCCCTGCATTGGTGGTTGGACATGAATG|CACGAGTGCTAGAGACAACTGTGAAGCGAA
ACCGACTAAAGTAAGGAACTCGACTTATGA|CCAGACTCGACTTATGATTTGCACGAGTGC
TCTACCATATTTCAACCGGGGAATCGCCAT|CCAAAAGGACACAGAGGGGTTACTAGACAC
AACCGACTAGGGTATTCATAGAGAACGAGG|ACGAAACGCGATATTCGCAGCATTGCCCTA
CGACTTATGATTTGCACGAGTGCTAGAGTG|GTTGGACATGAATGTGATCGTTTGGTGAAG
CGATCACAGACCGTCGCGATACACCTGGTG|AGTGAGGGTGATAACCATGACTCGACTTAT
GTTTCACGTACCATGATAAGGGCGCAGCGA|AGAAACCTTCGAGGGGGCTTCGCCCAGCCA
CAGGTTGTGGTATCCTAGAGTGAGGGTGAT|CGACCAGACTCGACTTATGATTTGCACGAG
CTAAACCACCTACTCTCCCACTCGACTTAT|CCGACTAAAGTAAGGAACTCGACTTATGAT
CACTCGACTTATGATTTGCACGAGTGCTAG|GATTTGCACGAGTGCTAGACCCTGCAGATG
ACCATGATAAGGGCGCAGCGACGAAACGCG|CGAGGGGGCTTCGCCCAGCCAGCTCGATGA
GCACGAGTGCTAGAAGACTAGACGCCAGCT|AAGGGCTGGAAGGACTCGACTTATGATTTG
GAGTGCTAGACCCTGCAGATGTCGATCACA|CCAACAGGTTGTGGTATCCTAGAGTGAGGG
ACCAGTGGTTGGCTTAACTCGACTTATGAT|TATCAACGCTAATAGTGGCTATTGCTGTCT
AGGACTCGACTTATGATTTGCACGAGTGCT|TGACGCGAATGCCATAGTTGGCCCCTGACG
CATCAACAACCGACTAGGGTATTCATAGAG|CGCAGCGACGAAACGCGATATTCGCAGCAT
CAACTGTGAAGCGAATGTAGAATCCAAGAT|GAGTCCTTGTACGGCGAATGTTGAATTGTT
CCATAAGTTTCACGTACCATGATAAGGGCG|ACACTCAGAAACCTTCGAGGGGGCTTCGCC
CCGTCGCGATACACCTGGTGTTGCTAAATG|ATAACCATGACTCGACTTATGATTTGCACG
CCCACTCGACTTATGATTTGCACGAGTGCT|ACTCGACTTATGATTTGCACGAGTGCTAGA
AACGACCAGACTCGACTTATGATTTGCACG|GCCGGAGATGTCTCTAGGGCATCAACAACC
TTTCAACCGGGGAATCGCCATAAGTTTCAC|CACAGAGGGGTTACTAGACACTCAGAAACC
CACACTCGACTTATGATTTGCACGAGTGCT|ATGATTTGCACGAGTGCTAGACCCTGCAGA
TGATCGTTTGGTGAAGTCGTAACTTGAGTC|TGTAGAATCCAAGATAAATCAATAGTAGAA
CTGCATTGGTGGTTGGACATGAATGTGATC|GTGCTAGAGACAACTGTGAAGCGAATGTAG
GATTTGCACGAGTGCTAGATCGTATCAATT|GCTAGATGACACTATTCACGGTATGCCATA
ATTACACACTGGGTGCGCCGGAGATGTCTC|GGAATCGCCATAAGTTTCACGTACCATGAT
TACGAGATTACACACTGGGTGCGCCGGAGA|AACCGGGGAATCGCCATAAGTTTCACGTAC
